MSOA code,March,April,May,June,July,5 month - March to July
E02000001,1,2,1,0,0,4
E02000002,1,7,0,0,0,8
E02000003,1,7,2,0,0,10
E02000004,6,6,1,1,0,14
E02000005,4,2,1,0,0,7
E02000007,6,5,3,0,0,14
E02000008,1,10,0,0,0,11
E02000009,2,5,0,0,0,7
E02000010,3,4,0,0,0,7
E02000011,1,8,1,2,0,12
E02000012,0,6,0,1,1,8
E02000013,2,2,0,0,0,4
E02000014,1,3,2,0,0,6
E02000015,1,3,0,0,0,4
E02000016,0,1,0,0,0,1
E02000017,0,5,1,0,0,6
E02000018,4,7,2,0,0,13
E02000019,3,3,2,0,0,8
E02000020,1,5,0,0,0,6
E02000021,1,5,0,0,0,6
E02000022,1,2,1,0,0,4
E02000023,1,2,1,0,0,4
E02000024,1,9,2,0,1,13
E02000025,3,12,0,0,1,16
E02000026,0,5,2,0,0,7
E02000027,1,11,2,0,0,14
E02000028,1,5,3,0,0,9
E02000029,1,7,1,0,0,9
E02000030,4,5,1,0,0,10
E02000031,4,11,1,0,0,16
E02000032,2,3,1,0,0,6
E02000033,0,11,0,0,0,11
E02000034,1,9,0,0,0,10
E02000035,1,22,1,0,0,24
E02000036,6,6,0,0,0,12
E02000037,6,8,0,0,0,14
E02000038,4,22,3,0,0,29
E02000039,2,5,0,0,0,7
E02000040,3,9,0,0,1,13
E02000041,2,10,5,0,1,18
E02000042,6,12,3,0,0,21
E02000043,1,6,0,0,0,7
E02000044,2,3,0,0,0,5
E02000045,1,3,1,0,0,5
E02000046,2,2,1,0,0,5
E02000047,2,7,2,0,0,11
E02000048,0,4,1,0,0,5
E02000049,1,6,0,0,0,7
E02000050,2,5,0,0,0,7
E02000051,2,9,1,0,0,12
E02000052,2,3,2,0,0,7
E02000053,0,5,0,0,0,5
E02000054,4,5,0,0,0,9
E02000055,2,8,4,0,0,14
E02000056,3,8,4,0,0,15
E02000057,2,10,0,1,0,13
E02000058,1,7,0,0,0,8
E02000059,7,11,1,2,0,21
E02000060,1,11,0,0,0,12
E02000061,5,9,4,0,0,18
E02000062,1,3,0,0,0,4
E02000063,2,4,2,0,0,8
E02000064,0,0,0,0,0,0
E02000065,0,3,1,0,0,4
E02000066,2,3,4,0,0,9
E02000067,3,2,1,0,0,6
E02000068,1,4,0,0,0,5
E02000069,2,3,0,1,0,6
E02000070,1,2,1,0,0,4
E02000071,0,4,2,1,1,8
E02000072,0,1,1,3,0,5
E02000073,2,11,2,0,0,15
E02000074,2,7,1,0,3,13
E02000075,1,3,0,0,2,6
E02000077,0,10,0,0,0,10
E02000078,1,4,0,0,0,5
E02000079,5,19,2,1,0,27
E02000080,0,3,0,0,0,3
E02000081,1,4,1,0,0,6
E02000082,0,6,2,0,0,8
E02000083,2,2,0,3,1,8
E02000084,1,4,2,0,1,8
E02000085,0,2,2,0,0,4
E02000086,0,5,1,0,0,6
E02000087,1,2,2,0,1,6
E02000088,0,2,0,0,0,2
E02000089,1,11,3,2,0,17
E02000090,3,7,7,1,0,18
E02000091,2,9,4,0,2,17
E02000092,2,6,0,1,0,9
E02000093,2,16,1,0,0,19
E02000094,2,6,2,0,0,10
E02000095,2,5,0,1,0,8
E02000096,4,4,0,0,0,8
E02000097,3,8,0,0,0,11
E02000098,3,20,2,2,0,27
E02000099,3,3,1,1,0,8
E02000100,1,8,6,0,0,15
E02000101,2,22,3,0,1,28
E02000102,3,7,0,0,0,10
E02000103,0,6,0,0,1,7
E02000104,5,11,1,1,0,18
E02000105,4,3,0,1,0,8
E02000106,4,11,3,1,0,19
E02000107,0,4,1,0,0,5
E02000108,2,6,0,0,0,8
E02000109,2,18,2,1,0,23
E02000110,3,2,0,0,0,5
E02000111,1,16,0,0,0,17
E02000112,2,15,3,0,0,20
E02000113,2,10,1,0,0,13
E02000114,1,7,1,0,0,9
E02000115,1,5,1,0,0,7
E02000116,2,11,0,0,0,13
E02000117,9,25,2,0,0,36
E02000118,3,19,1,2,0,25
E02000119,5,20,2,0,1,28
E02000120,1,3,2,0,0,6
E02000121,6,14,3,0,0,23
E02000122,3,9,0,0,0,12
E02000123,5,12,2,0,0,19
E02000124,2,4,1,0,0,7
E02000125,1,8,2,0,0,11
E02000126,0,6,2,0,0,8
E02000127,1,5,2,0,0,8
E02000128,0,3,4,0,1,8
E02000130,0,1,0,0,0,1
E02000131,2,6,0,0,0,8
E02000132,3,3,0,0,1,7
E02000133,2,8,2,0,0,12
E02000134,4,8,3,1,1,17
E02000135,4,10,7,0,0,21
E02000136,1,10,2,2,0,15
E02000137,2,9,2,0,0,13
E02000138,2,6,1,0,0,9
E02000139,0,6,1,0,0,7
E02000140,3,3,0,1,0,7
E02000141,1,6,0,0,0,7
E02000142,2,7,1,1,1,12
E02000144,2,2,0,0,0,4
E02000145,0,2,2,0,0,4
E02000146,2,10,3,0,1,16
E02000147,1,5,2,0,0,8
E02000148,0,5,1,0,0,6
E02000149,2,5,2,0,0,9
E02000150,0,5,0,0,0,5
E02000151,0,2,2,0,0,4
E02000152,0,2,1,1,0,4
E02000153,0,3,1,0,0,4
E02000154,0,1,3,0,0,4
E02000155,1,2,4,0,0,7
E02000156,1,10,5,1,0,17
E02000157,4,5,2,0,0,11
E02000158,1,4,1,1,0,7
E02000159,2,5,0,0,0,7
E02000160,3,5,4,0,0,12
E02000161,0,7,2,0,0,9
E02000162,0,9,4,1,0,14
E02000163,2,5,3,1,0,11
E02000165,0,3,1,0,0,4
E02000166,1,4,1,0,0,6
E02000167,0,2,0,0,0,2
E02000168,0,7,0,0,0,7
E02000169,1,5,1,0,0,7
E02000170,0,5,0,0,0,5
E02000171,1,5,0,0,0,6
E02000172,1,13,2,0,0,16
E02000173,0,0,0,0,0,0
E02000174,1,3,0,0,0,4
E02000175,0,4,0,0,0,4
E02000176,0,2,0,0,0,2
E02000177,1,11,1,0,1,14
E02000178,0,5,0,0,0,5
E02000179,1,4,0,0,1,6
E02000180,1,3,1,0,0,5
E02000181,0,1,0,0,0,1
E02000182,1,6,0,0,0,7
E02000183,1,5,0,0,0,6
E02000184,1,4,1,0,0,6
E02000185,3,9,1,0,0,13
E02000186,2,1,0,0,0,3
E02000187,4,4,2,0,0,10
E02000188,3,3,0,0,0,6
E02000189,0,3,0,0,0,3
E02000190,2,5,0,0,0,7
E02000191,0,2,0,0,0,2
E02000192,2,6,1,0,0,9
E02000193,1,0,0,0,0,1
E02000194,3,20,0,0,0,23
E02000195,0,19,4,0,0,23
E02000196,2,12,2,0,0,16
E02000197,2,5,2,0,0,9
E02000198,3,6,1,0,0,10
E02000199,3,8,2,0,0,13
E02000200,0,4,1,0,0,5
E02000201,2,4,0,0,0,6
E02000202,6,7,0,1,0,14
E02000203,5,12,2,0,0,19
E02000204,5,12,1,0,0,18
E02000206,1,3,1,0,0,5
E02000207,0,5,2,0,0,7
E02000208,0,6,2,0,0,8
E02000209,3,5,1,0,0,9
E02000210,2,1,2,0,0,5
E02000211,1,6,2,1,0,10
E02000212,0,2,1,0,0,3
E02000213,2,14,3,0,0,19
E02000214,1,9,3,0,0,13
E02000215,1,14,0,0,0,15
E02000216,1,8,2,0,0,11
E02000217,1,5,0,0,0,6
E02000218,0,3,1,0,0,4
E02000219,4,8,0,1,0,13
E02000220,1,19,3,0,0,23
E02000221,3,17,1,1,0,22
E02000222,0,3,1,0,0,4
E02000223,0,1,2,0,0,3
E02000224,1,5,1,0,0,7
E02000225,2,6,1,0,1,10
E02000226,1,6,4,1,0,12
E02000227,4,2,2,0,0,8
E02000228,7,11,3,2,0,23
E02000229,4,8,1,1,0,14
E02000230,4,7,3,0,0,14
E02000231,0,9,5,0,1,15
E02000232,0,5,1,1,0,7
E02000233,2,1,1,0,0,4
E02000234,2,8,1,1,0,12
E02000235,1,5,0,0,0,6
E02000236,2,5,1,1,0,9
E02000237,1,7,5,0,0,13
E02000238,3,2,0,0,0,5
E02000239,0,7,0,0,0,7
E02000240,2,10,0,0,0,12
E02000241,3,6,0,0,0,9
E02000242,1,10,0,0,0,11
E02000243,3,10,0,0,1,14
E02000244,1,2,0,0,0,3
E02000245,1,6,3,0,0,10
E02000246,0,4,0,0,0,4
E02000247,3,24,4,0,0,31
E02000248,2,3,1,0,0,6
E02000249,3,16,3,1,1,24
E02000250,1,9,3,1,0,14
E02000251,1,4,0,1,0,6
E02000252,0,0,0,0,0,0
E02000253,2,10,1,0,0,13
E02000254,4,8,2,1,0,15
E02000255,0,6,1,0,0,7
E02000256,1,2,0,0,0,3
E02000257,0,5,1,0,0,6
E02000258,1,5,1,0,0,7
E02000259,1,3,1,0,0,5
E02000260,1,11,4,2,0,18
E02000261,1,5,0,0,0,6
E02000262,9,15,3,1,0,28
E02000263,1,12,2,1,0,16
E02000264,1,5,0,0,0,6
E02000265,4,7,1,0,0,12
E02000266,5,17,1,1,0,24
E02000267,1,4,2,0,0,7
E02000268,0,7,1,1,0,9
E02000269,0,2,2,0,1,5
E02000270,2,7,0,0,0,9
E02000271,0,3,0,0,0,3
E02000272,1,4,0,0,0,5
E02000274,2,11,1,0,0,14
E02000275,3,19,2,0,1,25
E02000276,2,3,1,0,0,6
E02000277,1,4,2,0,0,7
E02000278,3,9,0,2,0,14
E02000279,1,3,0,1,0,5
E02000280,1,22,2,0,0,25
E02000281,2,3,1,1,0,7
E02000282,0,11,3,0,0,14
E02000283,1,2,0,0,0,3
E02000284,0,1,1,0,0,2
E02000285,1,4,1,0,0,6
E02000286,2,14,0,0,0,16
E02000287,2,16,0,0,0,18
E02000288,1,4,2,0,0,7
E02000289,0,3,0,0,0,3
E02000290,1,9,0,1,0,11
E02000291,1,11,5,0,0,17
E02000292,3,7,0,0,0,10
E02000293,2,1,1,0,0,4
E02000294,1,6,2,0,0,9
E02000295,2,5,0,0,0,7
E02000296,6,19,2,0,0,27
E02000297,1,5,0,0,1,7
E02000298,4,6,1,0,0,11
E02000299,2,7,0,0,0,9
E02000300,1,15,2,0,1,19
E02000301,1,7,0,0,0,8
E02000302,0,3,1,0,0,4
E02000303,1,7,0,0,0,8
E02000304,0,12,4,1,0,17
E02000305,1,9,0,1,0,11
E02000306,4,6,0,0,0,10
E02000307,4,5,0,0,0,9
E02000308,0,6,0,0,0,6
E02000309,2,15,0,1,0,18
E02000311,4,13,0,1,0,18
E02000312,4,5,0,0,0,9
E02000313,0,4,0,0,0,4
E02000314,2,9,1,0,0,12
E02000315,0,7,0,1,0,8
E02000316,6,0,0,0,0,6
E02000317,1,5,0,0,0,6
E02000318,0,6,0,0,0,6
E02000319,3,4,0,0,0,7
E02000320,5,4,0,0,0,9
E02000321,1,4,0,0,0,5
E02000323,2,8,1,0,0,11
E02000324,1,7,3,0,0,11
E02000326,4,1,0,0,0,5
E02000327,0,5,2,0,0,7
E02000328,0,10,0,0,0,10
E02000329,1,4,0,0,0,5
E02000331,4,4,1,0,0,9
E02000332,0,3,0,0,0,3
E02000333,4,0,0,0,0,4
E02000334,0,8,2,0,0,10
E02000335,1,2,0,0,0,3
E02000337,1,5,0,1,0,7
E02000339,0,8,0,0,0,8
E02000340,0,0,0,1,0,1
E02000341,2,6,0,0,0,8
E02000342,0,2,0,0,0,2
E02000343,1,5,1,0,0,7
E02000344,1,14,2,0,0,17
E02000345,2,6,0,0,0,8
E02000346,1,4,3,0,0,8
E02000347,0,6,0,0,0,6
E02000348,4,7,1,0,1,13
E02000350,3,7,1,0,0,11
E02000351,0,3,1,0,0,4
E02000352,0,10,1,0,1,12
E02000353,0,5,0,0,0,5
E02000354,1,6,0,0,0,7
E02000355,5,11,0,0,0,16
E02000356,1,3,0,0,0,4
E02000357,1,6,0,0,0,7
E02000358,2,9,1,0,0,12
E02000359,2,4,1,0,0,7
E02000360,1,6,0,0,0,7
E02000361,1,2,0,0,0,3
E02000362,0,0,1,0,0,1
E02000363,3,5,3,0,0,11
E02000364,5,2,1,0,0,8
E02000365,1,7,2,0,0,10
E02000366,2,4,0,0,0,6
E02000367,0,5,0,0,1,6
E02000368,2,5,1,0,0,8
E02000369,2,13,2,1,0,18
E02000370,4,5,0,0,0,9
E02000371,2,1,0,0,0,3
E02000372,0,10,1,0,0,11
E02000373,1,0,0,0,0,1
E02000374,4,7,1,0,0,12
E02000375,0,1,0,0,0,1
E02000376,2,2,1,0,0,5
E02000377,2,4,0,0,0,6
E02000378,1,5,0,0,0,6
E02000379,10,16,1,0,0,27
E02000380,0,2,1,0,0,3
E02000381,0,5,0,0,0,5
E02000382,1,0,0,0,0,1
E02000383,2,8,2,0,0,12
E02000384,4,15,1,0,0,20
E02000385,0,2,0,1,0,3
E02000386,2,3,0,0,0,5
E02000387,1,5,1,1,1,9
E02000388,5,11,0,1,0,17
E02000389,1,5,1,0,0,7
E02000390,0,0,0,0,0,0
E02000391,0,7,1,0,0,8
E02000392,1,1,0,0,0,2
E02000393,0,0,1,0,0,1
E02000394,2,2,0,0,0,4
E02000395,0,1,0,0,0,1
E02000396,0,2,1,0,0,3
E02000397,1,6,0,1,0,8
E02000398,1,7,1,0,0,9
E02000400,2,4,0,0,1,7
E02000401,2,3,3,0,0,8
E02000402,0,2,0,1,0,3
E02000403,3,2,0,0,0,5
E02000404,5,2,0,0,0,7
E02000405,1,7,0,0,0,8
E02000406,1,3,0,0,0,4
E02000407,2,5,1,0,0,8
E02000408,1,11,0,1,0,13
E02000409,3,4,0,0,0,7
E02000410,0,2,0,0,0,2
E02000411,1,5,2,1,0,9
E02000412,1,8,0,0,0,9
E02000413,0,5,1,0,0,6
E02000414,2,7,1,0,0,10
E02000415,2,3,1,0,0,6
E02000416,2,2,2,0,0,6
E02000417,2,4,0,0,0,6
E02000418,1,3,1,0,0,5
E02000419,2,3,1,0,0,6
E02000420,5,6,1,0,0,12
E02000421,2,16,5,1,0,24
E02000422,1,9,0,0,0,10
E02000423,1,2,1,1,0,5
E02000424,0,3,0,0,0,3
E02000425,1,12,0,0,0,13
E02000426,1,4,0,0,0,5
E02000427,1,3,2,0,0,6
E02000428,3,5,2,0,0,10
E02000429,2,5,0,0,0,7
E02000430,2,3,0,0,0,5
E02000431,1,1,0,0,0,2
E02000432,3,1,0,0,0,4
E02000433,11,13,2,3,0,29
E02000434,6,17,2,0,0,25
E02000435,3,9,0,1,0,13
E02000436,4,4,1,1,0,10
E02000437,2,13,5,0,1,21
E02000438,0,11,9,0,1,21
E02000439,3,6,2,0,0,11
E02000440,2,4,2,0,0,8
E02000441,5,5,3,0,0,13
E02000442,2,5,0,0,0,7
E02000443,3,15,1,0,0,19
E02000444,1,6,1,0,0,8
E02000445,6,15,5,0,1,27
E02000447,3,4,2,0,0,9
E02000448,1,5,0,0,0,6
E02000449,2,11,0,0,0,13
E02000451,3,1,1,0,0,5
E02000452,4,7,0,0,0,11
E02000453,1,4,0,1,0,6
E02000454,0,5,0,1,0,6
E02000455,4,10,4,0,0,18
E02000456,4,7,1,0,0,12
E02000457,3,5,1,1,0,10
E02000459,3,10,1,1,0,15
E02000460,3,7,0,0,0,10
E02000461,3,8,1,0,0,12
E02000462,1,5,2,0,0,8
E02000463,1,6,2,1,0,10
E02000464,1,5,2,1,0,9
E02000465,0,7,1,0,0,8
E02000466,0,8,2,0,0,10
E02000467,1,5,3,0,0,9
E02000468,0,12,0,0,0,12
E02000469,0,3,0,0,0,3
E02000470,1,9,0,0,0,10
E02000471,0,5,1,1,0,7
E02000472,1,5,2,0,0,8
E02000473,1,3,0,0,0,4
E02000474,2,4,0,0,0,6
E02000475,3,7,1,1,0,12
E02000476,4,2,2,0,0,8
E02000477,0,5,4,0,0,9
E02000478,3,4,0,0,0,7
E02000479,1,10,1,0,0,12
E02000480,3,11,1,0,0,15
E02000481,6,10,2,0,1,19
E02000482,0,5,0,0,0,5
E02000483,0,6,3,0,0,9
E02000484,1,8,1,0,0,10
E02000485,1,5,1,0,0,7
E02000486,1,7,2,0,0,10
E02000487,2,11,0,0,0,13
E02000488,0,5,3,0,0,8
E02000489,2,5,3,0,0,10
E02000490,0,7,1,0,0,8
E02000491,3,11,0,0,1,15
E02000492,2,3,2,0,0,7
E02000493,1,5,0,0,0,6
E02000494,1,4,3,0,0,8
E02000495,5,14,1,0,0,20
E02000496,3,23,0,0,0,26
E02000497,7,14,2,0,0,23
E02000498,1,4,0,0,0,5
E02000499,1,5,0,0,0,6
E02000500,1,7,0,0,0,8
E02000501,2,5,4,0,0,11
E02000502,3,9,2,0,0,14
E02000503,0,3,0,0,0,3
E02000504,2,1,0,0,0,3
E02000506,2,4,2,0,0,8
E02000507,0,7,1,0,0,8
E02000508,1,5,1,0,1,8
E02000509,1,5,0,0,0,6
E02000510,1,5,0,0,0,6
E02000511,0,10,0,1,0,11
E02000512,0,5,1,0,0,6
E02000513,3,5,1,0,0,9
E02000514,4,10,1,0,0,15
E02000515,1,5,0,1,0,7
E02000516,0,7,1,0,0,8
E02000517,3,6,2,1,0,12
E02000518,1,9,0,0,0,10
E02000519,1,3,0,0,0,4
E02000520,3,7,2,0,0,12
E02000521,2,6,0,0,1,9
E02000522,0,13,2,1,0,16
E02000523,0,4,2,0,0,6
E02000524,1,10,0,0,0,11
E02000525,2,5,0,1,0,8
E02000526,0,2,2,0,0,4
E02000528,1,9,1,0,0,11
E02000529,1,3,1,1,0,6
E02000530,2,5,2,0,0,9
E02000531,3,5,0,0,0,8
E02000532,1,3,0,0,0,4
E02000533,1,2,1,1,0,5
E02000534,1,3,0,0,0,4
E02000535,7,3,0,0,1,11
E02000536,1,6,0,0,0,7
E02000537,1,4,2,1,0,8
E02000538,1,5,0,0,0,6
E02000539,8,9,0,0,0,17
E02000540,6,9,2,2,0,19
E02000541,3,7,5,2,0,17
E02000542,2,12,0,1,0,15
E02000543,0,7,0,0,0,7
E02000544,1,1,1,1,0,4
E02000545,1,2,1,0,1,5
E02000546,0,4,3,0,0,7
E02000547,1,9,0,0,0,10
E02000548,2,4,0,0,1,7
E02000549,2,9,2,0,2,15
E02000550,0,1,0,1,0,2
E02000551,1,3,2,0,1,7
E02000552,1,1,2,0,0,4
E02000553,2,4,1,0,0,7
E02000554,1,0,0,0,0,1
E02000555,2,1,3,0,0,6
E02000556,4,5,1,0,1,11
E02000557,0,5,0,0,0,5
E02000558,0,6,1,0,0,7
E02000559,0,2,0,0,0,2
E02000560,0,2,0,0,0,2
E02000561,0,5,0,0,0,5
E02000562,1,5,1,0,0,7
E02000563,1,4,0,0,0,5
E02000564,1,4,0,0,0,5
E02000565,1,4,2,0,0,7
E02000566,1,1,1,0,0,3
E02000567,0,3,0,0,0,3
E02000568,1,11,0,0,0,12
E02000569,5,3,0,0,0,8
E02000570,1,2,1,0,0,4
E02000571,1,4,1,0,0,6
E02000572,2,5,1,1,0,9
E02000573,4,15,1,0,0,20
E02000574,0,6,2,1,0,9
E02000575,1,6,2,0,0,9
E02000576,3,2,1,0,0,6
E02000577,3,3,0,0,0,6
E02000578,5,8,0,0,0,13
E02000579,2,4,3,0,0,9
E02000580,1,6,0,0,0,7
E02000581,0,6,1,2,0,9
E02000582,1,6,1,0,0,8
E02000583,1,2,0,0,0,3
E02000584,1,0,0,0,0,1
E02000585,1,1,1,1,0,4
E02000586,0,0,0,0,0,0
E02000587,1,4,0,0,0,5
E02000588,1,1,0,0,0,2
E02000589,4,1,0,0,0,5
E02000590,1,3,0,0,0,4
E02000591,3,1,2,0,0,6
E02000592,1,3,0,0,0,4
E02000593,1,0,0,0,0,1
E02000594,2,12,1,0,1,16
E02000595,0,4,0,0,0,4
E02000596,1,11,2,0,0,14
E02000597,1,4,1,0,0,6
E02000598,0,2,0,0,0,2
E02000599,2,13,4,0,0,19
E02000600,3,4,3,1,0,11
E02000601,0,0,3,0,0,3
E02000602,0,2,1,0,0,3
E02000603,1,6,0,0,0,7
E02000604,2,2,0,0,0,4
E02000605,0,12,1,0,0,13
E02000606,1,3,0,0,0,4
E02000607,0,1,1,0,0,2
E02000608,0,0,0,0,0,0
E02000609,0,5,1,0,0,6
E02000610,1,7,4,0,0,12
E02000611,0,1,0,0,0,1
E02000612,1,9,4,0,0,14
E02000613,0,6,3,0,0,9
E02000614,1,4,1,1,0,7
E02000615,1,4,3,0,0,8
E02000616,0,1,0,0,0,1
E02000617,0,4,1,0,0,5
E02000619,2,5,2,0,0,9
E02000620,1,9,0,0,0,10
E02000621,4,5,0,0,0,9
E02000622,2,5,1,0,0,8
E02000623,1,4,1,0,0,6
E02000624,5,4,1,1,0,11
E02000625,1,7,1,0,0,9
E02000626,3,7,0,0,0,10
E02000627,1,3,1,0,0,5
E02000628,5,9,1,0,0,15
E02000629,0,2,0,0,0,2
E02000630,1,5,0,0,0,6
E02000631,2,3,1,0,0,6
E02000632,2,2,0,0,0,4
E02000633,1,6,1,0,1,9
E02000634,2,17,2,0,0,21
E02000635,3,5,1,0,0,9
E02000636,6,4,0,0,0,10
E02000637,3,3,1,0,0,7
E02000638,1,8,1,1,0,11
E02000639,2,4,1,0,0,7
E02000640,5,1,1,0,0,7
E02000641,3,4,2,0,0,9
E02000642,1,6,0,2,0,9
E02000643,2,8,4,0,0,14
E02000644,0,2,1,0,0,3
E02000645,1,2,1,0,0,4
E02000646,2,3,2,1,0,8
E02000647,5,9,1,0,0,15
E02000648,2,8,2,0,0,12
E02000649,3,5,1,0,0,9
E02000650,1,6,0,0,0,7
E02000651,1,4,1,0,0,6
E02000652,0,3,0,0,0,3
E02000653,1,12,1,0,0,14
E02000654,2,7,0,0,0,9
E02000655,6,10,2,0,0,18
E02000657,1,2,1,0,0,4
E02000658,2,2,1,0,0,5
E02000659,1,3,0,0,0,4
E02000660,1,4,0,0,0,5
E02000661,1,3,0,1,0,5
E02000662,1,3,0,0,0,4
E02000663,0,7,0,0,0,7
E02000664,3,8,4,2,0,17
E02000665,2,2,1,0,0,5
E02000666,1,10,1,0,0,12
E02000667,0,4,0,0,0,4
E02000668,1,5,0,0,0,6
E02000669,3,4,2,0,0,9
E02000670,2,6,1,1,0,10
E02000671,1,3,0,0,0,4
E02000672,3,4,0,0,0,7
E02000673,0,1,0,0,0,1
E02000674,1,9,0,0,0,10
E02000675,1,5,1,0,0,7
E02000676,1,5,1,0,0,7
E02000677,1,7,3,1,0,12
E02000678,2,3,0,0,0,5
E02000679,2,6,2,0,0,10
E02000680,2,4,2,0,0,8
E02000681,2,7,0,0,0,9
E02000682,1,4,1,1,0,7
E02000683,0,4,2,1,0,7
E02000685,2,11,0,1,0,14
E02000686,1,5,0,0,0,6
E02000687,1,12,3,0,0,16
E02000689,0,2,0,0,0,2
E02000690,0,5,1,0,0,6
E02000691,1,4,0,0,0,5
E02000692,2,8,3,0,0,13
E02000693,2,7,0,0,0,9
E02000694,1,2,0,0,0,3
E02000695,0,6,0,0,0,6
E02000696,3,4,0,0,0,7
E02000697,1,1,0,0,0,2
E02000698,1,2,0,0,0,3
E02000699,0,3,0,0,0,3
E02000700,0,9,2,0,0,11
E02000701,3,10,0,0,0,13
E02000702,2,4,1,0,0,7
E02000703,1,3,2,0,0,6
E02000704,2,15,2,1,0,20
E02000705,5,8,2,0,0,15
E02000706,0,6,0,0,0,6
E02000707,4,3,0,0,0,7
E02000708,1,4,2,1,0,8
E02000709,1,4,2,0,0,7
E02000710,2,14,3,0,0,19
E02000711,2,4,1,1,0,8
E02000712,1,7,2,1,0,11
E02000713,1,5,0,1,0,7
E02000714,2,4,0,0,0,6
E02000715,8,16,2,2,0,28
E02000716,2,15,1,0,0,18
E02000717,1,4,0,0,1,6
E02000718,0,1,1,0,0,2
E02000719,2,9,0,0,0,11
E02000720,1,3,2,2,0,8
E02000721,5,7,0,1,0,13
E02000722,1,6,0,0,0,7
E02000723,4,8,0,1,0,13
E02000724,1,11,2,0,1,15
E02000725,1,4,0,1,0,6
E02000726,1,4,1,0,0,6
E02000727,1,4,1,0,0,6
E02000728,2,4,0,0,0,6
E02000729,3,8,1,0,0,12
E02000730,0,4,2,0,0,6
E02000731,2,6,0,0,0,8
E02000732,2,5,1,0,0,8
E02000733,1,3,1,0,0,5
E02000734,1,6,2,0,0,9
E02000735,0,8,0,0,0,8
E02000736,2,3,0,0,0,5
E02000737,3,7,1,0,0,11
E02000738,0,5,0,0,0,5
E02000739,1,2,2,0,1,6
E02000740,1,3,0,0,0,4
E02000741,3,4,0,0,0,7
E02000742,0,7,1,0,0,8
E02000743,1,10,0,0,0,11
E02000744,3,7,0,0,0,10
E02000745,2,4,1,0,0,7
E02000746,2,6,0,0,0,8
E02000747,1,4,0,0,0,5
E02000748,1,2,1,0,0,4
E02000749,2,5,0,0,0,7
E02000750,1,3,0,0,0,4
E02000751,5,7,0,0,0,12
E02000752,1,3,3,0,0,7
E02000753,1,2,0,0,0,3
E02000754,1,4,0,0,0,5
E02000755,0,4,2,0,0,6
E02000756,3,11,1,1,0,16
E02000757,0,5,2,0,0,7
E02000758,1,4,2,0,0,7
E02000759,5,7,0,1,0,13
E02000760,3,7,1,0,0,11
E02000762,0,6,2,0,0,8
E02000763,1,6,0,0,0,7
E02000764,2,10,4,0,0,16
E02000765,0,0,0,0,0,0
E02000767,2,10,5,3,0,20
E02000768,0,1,2,0,0,3
E02000769,5,14,1,0,0,20
E02000770,2,5,2,0,0,9
E02000772,2,5,1,0,0,8
E02000773,1,6,1,0,0,8
E02000774,1,1,0,0,0,2
E02000776,2,4,0,0,0,6
E02000777,0,5,0,0,0,5
E02000779,3,9,1,0,0,13
E02000780,1,14,0,0,0,15
E02000781,6,10,4,1,0,21
E02000782,2,14,4,0,0,20
E02000783,0,0,0,0,0,0
E02000784,1,6,0,0,0,7
E02000785,1,5,2,0,0,8
E02000786,0,4,0,0,0,4
E02000787,0,2,1,0,0,3
E02000788,1,6,1,0,0,8
E02000789,1,5,0,0,0,6
E02000790,0,4,0,0,0,4
E02000791,1,1,0,1,1,4
E02000792,2,10,1,2,0,15
E02000793,2,9,0,0,0,11
E02000794,2,2,1,1,0,6
E02000795,0,2,0,0,0,2
E02000796,1,10,1,0,0,12
E02000797,0,2,0,0,0,2
E02000798,0,4,1,0,1,6
E02000799,0,6,1,0,0,7
E02000800,1,2,0,0,0,3
E02000801,0,1,0,0,0,1
E02000802,1,13,5,0,0,19
E02000803,1,4,2,0,0,7
E02000804,3,5,0,0,1,9
E02000805,1,2,0,0,0,3
E02000806,2,3,1,0,0,6
E02000807,2,0,1,0,0,3
E02000808,0,2,0,0,0,2
E02000809,0,2,0,0,0,2
E02000810,1,0,0,0,0,1
E02000812,11,10,3,0,0,24
E02000813,0,4,0,0,0,4
E02000814,5,9,1,0,0,15
E02000815,0,3,1,0,0,4
E02000816,3,6,0,0,0,9
E02000817,2,8,2,1,0,13
E02000818,2,3,2,0,0,7
E02000819,2,6,0,0,0,8
E02000820,1,2,1,0,0,4
E02000821,1,6,0,0,0,7
E02000822,1,6,1,0,0,8
E02000823,0,2,0,1,0,3
E02000824,0,8,2,0,0,10
E02000825,5,6,1,0,0,12
E02000826,4,8,2,0,0,14
E02000827,2,0,0,0,1,3
E02000828,2,6,0,0,2,10
E02000829,4,18,3,1,0,26
E02000830,0,6,1,1,0,8
E02000831,2,4,0,0,0,6
E02000832,3,2,2,0,0,7
E02000833,2,1,2,0,0,5
E02000834,2,5,1,0,0,8
E02000835,1,2,1,0,0,4
E02000836,2,2,1,0,0,5
E02000837,2,1,0,0,0,3
E02000838,1,3,0,0,0,4
E02000839,1,1,1,0,0,3
E02000840,0,2,0,1,0,3
E02000841,0,5,0,1,0,6
E02000842,0,13,1,0,0,14
E02000843,3,5,0,0,0,8
E02000844,1,0,0,0,0,1
E02000845,0,0,3,0,0,3
E02000846,0,2,2,0,0,4
E02000847,2,5,1,0,0,8
E02000848,0,4,2,0,0,6
E02000849,1,4,0,0,0,5
E02000850,3,7,1,0,0,11
E02000851,4,6,2,2,0,14
E02000852,1,4,0,0,0,5
E02000853,1,4,1,1,0,7
E02000854,0,2,2,0,0,4
E02000855,1,4,1,0,0,6
E02000856,0,6,1,0,1,8
E02000857,1,13,4,1,0,19
E02000858,0,3,0,0,0,3
E02000859,3,7,3,0,0,13
E02000860,0,6,1,0,0,7
E02000861,1,5,1,0,0,7
E02000863,2,2,0,0,0,4
E02000864,3,8,1,0,0,12
E02000865,0,2,1,0,0,3
E02000866,1,3,1,1,0,6
E02000867,1,3,0,0,0,4
E02000868,1,7,0,0,0,8
E02000869,1,5,1,0,0,7
E02000870,1,5,1,0,0,7
E02000871,1,6,0,0,0,7
E02000872,0,2,0,0,0,2
E02000873,2,4,0,1,0,7
E02000874,0,1,0,0,0,1
E02000875,3,4,0,1,0,8
E02000876,0,2,0,0,0,2
E02000877,1,3,1,0,0,5
E02000878,1,4,0,0,0,5
E02000879,4,5,1,0,0,10
E02000880,1,0,1,0,0,2
E02000881,2,7,1,0,0,10
E02000882,4,9,0,0,0,13
E02000883,2,5,0,1,0,8
E02000884,1,1,0,0,0,2
E02000885,4,4,0,0,0,8
E02000886,0,3,0,0,0,3
E02000887,1,19,0,1,0,21
E02000888,0,2,0,0,0,2
E02000889,1,1,0,0,0,2
E02000890,0,0,1,0,0,1
E02000891,1,2,0,0,0,3
E02000893,1,5,1,0,0,7
E02000894,3,5,0,0,0,8
E02000895,5,8,1,2,0,16
E02000896,7,16,5,0,0,28
E02000897,1,6,4,0,0,11
E02000898,1,14,1,0,0,16
E02000899,3,1,2,0,0,6
E02000900,0,7,1,0,0,8
E02000901,2,3,0,1,0,6
E02000902,2,2,0,1,0,5
E02000903,0,3,0,0,0,3
E02000904,0,6,1,0,0,7
E02000905,2,9,2,0,1,14
E02000906,0,5,1,0,0,6
E02000907,0,5,2,1,0,8
E02000908,3,3,0,1,0,7
E02000909,2,2,2,0,0,6
E02000910,1,6,0,0,0,7
E02000911,4,4,1,0,0,9
E02000912,0,6,0,0,0,6
E02000913,0,5,0,0,0,5
E02000914,2,14,9,0,0,25
E02000915,2,4,2,1,0,9
E02000916,1,5,0,0,0,6
E02000917,2,2,1,1,0,6
E02000918,1,2,1,0,0,4
E02000919,0,4,0,0,0,4
E02000920,1,3,1,0,0,5
E02000921,1,6,0,0,0,7
E02000922,2,9,1,0,0,12
E02000923,3,6,1,0,0,10
E02000924,3,6,3,1,0,13
E02000925,2,6,1,0,0,9
E02000926,2,8,1,0,0,11
E02000927,4,0,0,0,0,4
E02000928,0,0,0,0,0,0
E02000929,0,3,0,0,0,3
E02000930,0,1,1,0,0,2
E02000931,2,2,1,0,0,5
E02000932,1,2,0,0,0,3
E02000933,0,3,0,0,0,3
E02000934,0,1,0,1,0,2
E02000935,1,0,1,0,0,2
E02000936,2,1,0,0,0,3
E02000937,2,0,0,0,0,2
E02000938,1,6,3,0,0,10
E02000939,4,12,2,0,1,19
E02000940,1,1,0,0,0,2
E02000941,3,3,0,0,1,7
E02000942,2,4,0,0,0,6
E02000943,1,2,0,1,0,4
E02000944,1,6,1,0,0,8
E02000945,6,5,1,0,0,12
E02000946,0,3,0,0,0,3
E02000947,0,3,0,0,0,3
E02000948,6,2,0,0,0,8
E02000949,3,7,0,0,0,10
E02000950,1,1,1,0,0,3
E02000951,2,1,0,0,0,3
E02000952,0,3,1,0,0,4
E02000953,0,2,0,0,0,2
E02000954,0,6,0,1,0,7
E02000955,2,3,0,0,0,5
E02000956,3,3,1,0,0,7
E02000957,1,4,0,0,0,5
E02000958,4,4,0,0,0,8
E02000959,3,5,0,0,0,8
E02000960,1,3,1,0,0,5
E02000961,3,6,0,0,0,9
E02000962,7,6,0,1,0,14
E02000963,1,10,2,0,0,13
E02000964,3,6,1,0,0,10
E02000965,1,2,0,0,0,3
E02000966,1,2,0,0,0,3
E02000967,2,5,0,0,0,7
E02000968,7,13,1,0,0,21
E02000969,3,13,2,1,1,20
E02000970,1,1,1,0,0,3
E02000971,1,3,0,0,0,4
E02000972,2,7,0,0,0,9
E02000973,2,2,1,0,0,5
E02000974,0,2,1,0,0,3
E02000975,2,3,0,0,0,5
E02000976,2,3,1,0,0,6
E02000977,0,2,0,0,0,2
E02000978,1,3,0,0,0,4
E02000979,3,10,0,0,0,13
E02000980,1,10,0,0,0,11
E02000981,1,1,1,0,0,3
E02000982,4,4,0,0,0,8
E02000983,1,4,0,0,0,5
E02000984,0,3,2,0,0,5
E02000985,0,2,4,1,0,7
E02000986,0,3,4,0,0,7
E02000987,1,10,1,0,0,12
E02000988,1,6,3,3,0,13
E02000989,0,4,3,0,0,7
E02000990,0,4,1,0,0,5
E02000991,1,5,1,0,1,8
E02000992,0,7,2,0,0,9
E02000993,0,4,2,0,0,6
E02000994,0,2,0,1,1,4
E02000995,0,6,2,0,0,8
E02000996,0,11,2,0,0,13
E02000997,0,5,8,1,0,14
E02000998,0,3,2,0,0,5
E02000999,0,7,1,1,0,9
E02001000,0,8,4,0,0,12
E02001001,0,3,5,1,0,9
E02001002,1,3,0,0,1,5
E02001003,0,7,1,1,0,9
E02001004,0,10,0,0,0,10
E02001005,0,10,0,1,2,13
E02001006,1,10,1,2,0,14
E02001007,0,8,4,1,0,13
E02001008,0,12,2,0,0,14
E02001009,0,6,0,1,0,7
E02001010,0,16,6,0,1,23
E02001011,0,3,4,2,0,9
E02001012,0,4,3,1,0,8
E02001013,0,4,1,0,0,5
E02001014,2,9,1,0,0,12
E02001015,0,3,6,0,0,9
E02001016,1,4,1,0,0,6
E02001017,0,7,1,0,0,8
E02001018,0,2,1,0,0,3
E02001019,1,5,1,1,0,8
E02001020,1,3,1,0,0,5
E02001021,2,4,2,0,0,8
E02001022,2,6,6,8,0,22
E02001023,0,4,2,0,0,6
E02001024,0,5,3,0,0,8
E02001025,2,4,5,3,0,14
E02001026,1,3,1,3,0,8
E02001027,1,10,4,2,0,17
E02001028,0,5,3,4,1,13
E02001029,0,4,1,0,0,5
E02001030,0,2,0,0,0,2
E02001031,0,2,0,2,0,4
E02001032,0,3,3,1,0,7
E02001033,0,1,0,1,0,2
E02001034,0,13,4,0,0,17
E02001035,1,4,2,1,0,8
E02001036,2,2,0,0,0,4
E02001037,1,13,3,2,1,20
E02001038,1,3,2,0,0,6
E02001039,0,4,0,2,1,7
E02001040,0,2,0,0,0,2
E02001041,0,8,2,0,0,10
E02001042,1,5,1,0,0,7
E02001043,1,10,6,3,0,20
E02001044,1,5,4,0,1,11
E02001045,1,4,0,1,1,7
E02001046,0,5,3,3,1,12
E02001047,0,11,1,0,0,12
E02001048,1,7,1,1,0,10
E02001049,2,9,4,0,0,15
E02001050,0,2,2,0,0,4
E02001051,0,6,2,0,0,8
E02001052,1,7,3,2,3,16
E02001053,0,3,1,2,0,6
E02001055,1,8,6,1,0,16
E02001056,0,5,4,0,0,9
E02001057,0,3,2,0,0,5
E02001059,0,5,3,0,0,8
E02001061,0,10,1,0,0,11
E02001062,0,5,1,0,0,6
E02001063,0,3,1,1,0,5
E02001064,2,8,2,0,0,12
E02001065,0,0,1,2,0,3
E02001066,0,3,1,1,0,5
E02001067,0,5,2,0,1,8
E02001068,0,10,2,0,0,12
E02001069,1,4,3,0,0,8
E02001070,0,4,2,0,0,6
E02001071,0,2,2,1,0,5
E02001072,0,7,0,0,0,7
E02001073,0,6,0,0,0,6
E02001074,0,12,6,0,0,18
E02001075,0,5,1,0,0,6
E02001076,0,2,0,0,0,2
E02001077,0,3,0,0,1,4
E02001078,1,6,1,0,0,8
E02001079,1,1,3,0,0,5
E02001080,0,2,0,0,0,2
E02001081,1,2,0,0,2,5
E02001082,0,5,5,4,0,14
E02001083,0,6,0,0,0,6
E02001084,0,1,0,0,1,2
E02001085,0,4,3,0,1,8
E02001086,0,8,2,1,0,11
E02001087,0,1,1,1,0,3
E02001088,1,6,3,0,0,10
E02001089,0,1,0,1,0,2
E02001090,0,7,0,0,0,7
E02001091,0,6,0,1,0,7
E02001092,1,5,1,0,0,7
E02001093,1,11,6,1,2,21
E02001094,0,1,1,3,0,5
E02001095,0,7,3,1,1,12
E02001096,1,4,4,0,0,9
E02001097,1,10,4,0,0,15
E02001098,1,5,2,1,0,9
E02001099,1,1,0,1,0,3
E02001100,0,5,5,4,0,14
E02001101,0,4,1,0,0,5
E02001102,2,0,3,0,0,5
E02001103,0,3,0,1,0,4
E02001104,0,1,1,0,0,2
E02001105,0,5,0,1,0,6
E02001106,1,6,1,0,1,9
E02001107,1,1,1,0,0,3
E02001108,1,4,0,0,0,5
E02001109,0,5,1,0,0,6
E02001110,1,18,1,0,0,20
E02001111,0,6,2,1,0,9
E02001112,1,4,0,1,0,6
E02001113,1,2,1,0,0,4
E02001114,0,26,4,1,2,33
E02001115,1,3,2,0,0,6
E02001116,1,11,2,0,0,14
E02001117,0,4,2,0,0,6
E02001118,0,5,2,0,0,7
E02001119,3,2,2,2,0,9
E02001121,0,2,1,0,0,3
E02001123,0,0,2,0,0,2
E02001124,1,3,0,0,0,4
E02001125,0,6,3,0,0,9
E02001126,0,11,2,0,0,13
E02001127,0,2,1,0,0,3
E02001128,0,3,1,1,0,5
E02001129,3,6,1,0,0,10
E02001130,3,5,2,0,0,10
E02001131,2,3,0,0,0,5
E02001132,1,5,2,1,0,9
E02001133,1,2,1,0,0,4
E02001134,0,2,1,0,0,3
E02001135,0,5,1,0,0,6
E02001136,0,3,1,1,0,5
E02001137,2,3,0,0,0,5
E02001138,0,10,2,2,1,15
E02001139,0,3,1,1,0,5
E02001140,0,7,2,1,0,10
E02001141,0,0,1,1,1,3
E02001142,1,4,0,0,0,5
E02001143,2,6,0,1,0,9
E02001144,2,4,3,0,0,9
E02001145,0,5,0,0,0,5
E02001146,3,7,5,2,1,18
E02001147,0,5,2,1,1,9
E02001148,4,16,3,2,0,25
E02001149,1,6,3,2,1,13
E02001150,1,8,2,3,0,14
E02001151,3,3,4,1,0,11
E02001152,1,1,0,0,1,3
E02001153,3,6,4,2,0,15
E02001154,2,4,5,0,1,12
E02001155,0,1,0,1,2,4
E02001156,2,7,2,3,0,14
E02001157,2,17,3,0,0,22
E02001158,2,8,3,0,0,13
E02001159,0,4,2,0,0,6
E02001160,1,8,1,0,0,10
E02001161,2,6,0,0,0,8
E02001162,1,1,2,1,0,5
E02001163,0,6,0,1,0,7
E02001164,0,2,2,1,0,5
E02001165,1,5,1,0,0,7
E02001166,0,22,1,2,1,26
E02001167,2,5,0,0,0,7
E02001168,2,14,3,0,0,19
E02001169,3,2,0,0,1,6
E02001170,5,11,3,0,1,20
E02001171,0,1,0,0,0,1
E02001172,5,15,9,3,0,32
E02001173,1,0,1,0,0,2
E02001174,3,9,0,0,1,13
E02001175,0,0,2,0,0,2
E02001176,5,12,5,0,0,22
E02001177,3,6,7,2,0,18
E02001178,1,3,0,0,0,4
E02001179,2,7,1,1,0,11
E02001180,0,6,0,1,0,7
E02001181,1,4,1,0,0,6
E02001182,0,9,2,0,0,11
E02001183,0,3,0,0,0,3
E02001184,1,2,0,0,0,3
E02001185,0,11,2,0,0,13
E02001186,2,10,1,0,1,14
E02001187,0,6,1,3,0,10
E02001188,0,5,1,0,0,6
E02001189,0,5,1,0,0,6
E02001190,0,12,2,0,0,14
E02001191,0,3,2,0,0,5
E02001192,1,6,3,1,1,12
E02001193,0,0,1,0,0,1
E02001194,3,3,1,0,0,7
E02001195,0,10,3,0,0,13
E02001196,1,7,2,1,1,12
E02001197,0,3,1,0,0,4
E02001198,0,16,11,0,0,27
E02001199,0,4,2,0,0,6
E02001200,0,5,4,0,1,10
E02001201,0,1,3,0,1,5
E02001202,0,4,2,0,0,6
E02001203,1,3,1,0,1,6
E02001204,1,9,0,0,0,10
E02001205,1,3,1,0,0,5
E02001206,1,4,6,0,1,12
E02001207,2,2,3,0,1,8
E02001208,0,7,0,0,0,7
E02001209,1,10,2,0,0,13
E02001210,0,7,2,2,0,11
E02001211,1,2,0,0,0,3
E02001212,0,7,4,1,0,12
E02001213,0,8,2,2,2,14
E02001214,0,3,2,0,0,5
E02001215,0,2,11,0,0,13
E02001216,1,1,1,1,2,6
E02001217,1,7,1,1,0,10
E02001218,2,2,3,0,0,7
E02001219,2,1,2,0,0,5
E02001220,0,3,0,1,1,5
E02001221,1,5,0,1,0,7
E02001222,1,3,0,0,0,4
E02001223,0,7,2,0,0,9
E02001224,3,3,5,3,0,14
E02001225,3,6,3,0,0,12
E02001226,0,2,2,0,1,5
E02001227,0,6,2,1,0,9
E02001228,3,11,2,0,0,16
E02001229,4,3,8,2,0,17
E02001230,3,3,2,1,0,9
E02001231,0,5,2,2,0,9
E02001232,3,4,0,3,0,10
E02001233,0,7,4,0,1,12
E02001234,3,6,1,3,1,14
E02001235,0,7,0,1,0,8
E02001236,2,4,2,1,0,9
E02001237,2,3,3,0,1,9
E02001238,0,5,1,2,0,8
E02001239,2,7,3,1,0,13
E02001240,0,3,1,3,2,9
E02001241,5,3,2,1,1,12
E02001242,0,6,3,2,1,12
E02001243,1,3,0,1,0,5
E02001244,0,2,2,1,0,5
E02001245,0,9,2,2,1,14
E02001246,0,4,3,1,0,8
E02001247,0,11,2,2,0,15
E02001248,1,3,0,2,0,6
E02001249,0,1,1,0,0,2
E02001250,0,3,2,0,0,5
E02001251,1,3,3,2,1,10
E02001252,0,7,2,2,1,12
E02001253,0,4,2,2,0,8
E02001254,0,2,2,0,0,4
E02001255,0,1,2,2,0,5
E02001256,3,10,11,2,1,27
E02001257,0,9,5,2,1,17
E02001258,0,2,3,2,0,7
E02001259,1,5,1,1,0,8
E02001260,0,3,0,0,0,3
E02001261,0,4,1,0,0,5
E02001262,0,4,0,1,0,5
E02001263,0,4,3,0,0,7
E02001264,2,0,1,0,0,3
E02001265,2,10,4,1,0,17
E02001266,1,2,1,1,1,6
E02001267,1,8,7,3,0,19
E02001268,0,5,1,0,1,7
E02001269,0,3,3,0,1,7
E02001270,1,5,0,3,0,9
E02001271,0,5,0,0,1,6
E02001272,0,4,1,2,0,7
E02001273,0,9,1,1,0,11
E02001274,0,5,3,1,0,9
E02001275,0,6,5,0,1,12
E02001276,2,8,3,1,0,14
E02001277,1,0,1,0,0,2
E02001278,0,8,2,0,0,10
E02001279,0,5,1,0,0,6
E02001280,0,5,7,0,0,12
E02001281,0,6,3,1,1,11
E02001282,1,3,2,0,0,6
E02001283,2,9,1,1,1,14
E02001284,0,2,3,1,0,6
E02001285,0,2,7,4,0,13
E02001286,2,5,2,2,1,12
E02001287,0,2,1,0,0,3
E02001288,1,10,3,0,0,14
E02001289,1,6,0,1,0,8
E02001290,0,3,1,0,0,4
E02001291,0,2,3,1,0,6
E02001292,0,5,1,1,0,7
E02001293,1,7,2,0,0,10
E02001294,0,3,3,1,1,8
E02001295,0,5,4,1,0,10
E02001296,0,6,1,0,0,7
E02001297,0,4,4,1,0,9
E02001298,0,5,1,1,0,7
E02001299,0,4,7,0,0,11
E02001300,0,16,4,0,0,20
E02001301,0,11,2,0,0,13
E02001302,0,9,4,0,0,13
E02001303,0,5,1,1,0,7
E02001304,1,3,1,0,1,6
E02001305,0,7,4,0,0,11
E02001306,0,3,0,0,0,3
E02001307,0,7,2,1,0,10
E02001308,0,4,2,5,0,11
E02001309,0,3,2,0,0,5
E02001310,0,5,1,1,0,7
E02001311,1,6,4,2,0,13
E02001312,1,5,1,0,0,7
E02001313,1,8,5,2,1,17
E02001314,0,1,0,0,0,1
E02001315,0,5,2,0,0,7
E02001316,1,2,0,0,0,3
E02001317,0,16,15,1,0,32
E02001318,0,3,1,0,0,4
E02001319,0,8,5,0,0,13
E02001320,0,4,0,0,0,4
E02001321,0,2,0,1,1,4
E02001322,0,12,3,0,0,15
E02001323,0,2,1,0,1,4
E02001324,0,3,0,1,0,4
E02001325,0,1,6,0,0,7
E02001326,1,4,2,1,1,9
E02001327,1,8,0,0,0,9
E02001328,1,1,1,0,0,3
E02001329,0,2,3,0,0,5
E02001330,0,2,3,1,0,6
E02001331,0,7,2,0,0,9
E02001332,0,9,6,0,0,15
E02001333,0,5,2,1,0,8
E02001334,1,3,2,0,0,6
E02001335,0,5,1,0,0,6
E02001336,1,2,3,0,0,6
E02001337,0,6,3,0,0,9
E02001338,0,5,3,2,0,10
E02001339,0,3,1,0,0,4
E02001340,0,0,1,0,0,1
E02001341,0,5,1,1,0,7
E02001342,0,11,4,0,0,15
E02001343,1,1,0,0,0,2
E02001344,0,5,4,1,0,10
E02001345,0,3,0,1,0,4
E02001346,1,7,0,0,1,9
E02001347,2,9,1,1,0,13
E02001348,0,6,6,1,2,15
E02001349,0,6,0,0,0,6
E02001350,1,16,1,0,0,18
E02001351,0,12,1,1,1,15
E02001352,0,5,0,1,0,6
E02001353,1,2,0,0,0,3
E02001354,0,5,2,0,0,7
E02001355,1,7,0,0,0,8
E02001356,0,3,1,0,0,4
E02001357,0,5,1,0,0,6
E02001358,2,7,2,0,0,11
E02001359,0,3,0,0,0,3
E02001360,0,6,1,0,0,7
E02001361,1,10,0,0,0,11
E02001362,0,15,1,1,0,17
E02001363,2,4,2,0,0,8
E02001364,2,2,4,1,0,9
E02001365,1,13,2,0,0,16
E02001366,2,3,0,0,0,5
E02001367,2,6,3,1,0,12
E02001368,1,11,0,0,0,12
E02001369,2,1,1,0,0,4
E02001370,2,7,0,1,0,10
E02001371,1,19,5,1,0,26
E02001372,0,7,10,0,0,17
E02001373,0,5,1,0,0,6
E02001374,0,5,1,0,0,6
E02001375,0,6,3,0,0,9
E02001376,0,4,1,0,0,5
E02001377,1,8,1,0,0,10
E02001378,1,8,2,1,0,12
E02001380,2,13,3,1,0,19
E02001381,0,7,0,1,0,8
E02001382,0,6,0,0,0,6
E02001383,0,5,1,0,1,7
E02001384,0,5,0,0,0,5
E02001385,1,2,0,0,1,4
E02001386,2,7,0,1,0,10
E02001387,2,5,1,1,0,9
E02001388,2,8,1,0,0,11
E02001389,0,3,1,0,0,4
E02001390,0,9,4,0,0,13
E02001391,0,2,1,1,0,4
E02001392,0,8,1,0,0,9
E02001393,0,4,0,0,0,4
E02001394,0,17,3,0,0,20
E02001395,0,3,0,1,0,4
E02001396,1,9,2,0,0,12
E02001397,2,11,1,1,1,16
E02001398,0,2,1,1,0,4
E02001399,1,3,0,0,0,4
E02001400,2,5,5,1,0,13
E02001401,2,17,2,0,0,21
E02001402,0,27,3,0,1,31
E02001403,0,3,1,1,0,5
E02001404,0,3,0,0,0,3
E02001405,2,9,1,0,0,12
E02001406,0,6,1,0,2,9
E02001407,0,4,1,0,0,5
E02001408,0,2,1,0,0,3
E02001409,0,5,2,1,0,8
E02001410,0,9,3,0,0,12
E02001411,0,8,6,1,0,15
E02001412,0,4,1,0,0,5
E02001413,0,7,2,0,0,9
E02001414,0,4,0,0,1,5
E02001415,0,1,0,0,0,1
E02001416,0,3,1,0,0,4
E02001417,1,7,5,0,0,13
E02001418,0,5,1,0,0,6
E02001419,0,10,3,1,0,14
E02001420,1,6,2,0,0,9
E02001421,0,3,0,0,0,3
E02001422,1,6,2,0,0,9
E02001423,0,5,3,1,0,9
E02001424,2,10,11,1,0,24
E02001425,0,11,1,2,0,14
E02001426,0,7,2,0,0,9
E02001427,0,3,2,1,0,6
E02001428,0,7,1,0,0,8
E02001429,0,4,5,1,0,10
E02001430,0,6,3,0,1,10
E02001431,0,7,4,3,1,15
E02001432,0,11,0,0,0,11
E02001433,1,2,0,0,1,4
E02001434,0,9,2,0,0,11
E02001435,1,3,1,0,0,5
E02001436,0,7,1,0,0,8
E02001437,2,12,5,1,1,21
E02001438,0,4,2,0,0,6
E02001439,0,5,2,0,0,7
E02001440,2,6,0,1,0,9
E02001441,1,5,2,0,0,8
E02001442,1,1,2,0,0,4
E02001443,1,1,0,0,0,2
E02001444,0,4,0,0,0,4
E02001445,1,1,1,1,1,5
E02001446,0,4,2,1,0,7
E02001447,0,4,2,0,0,6
E02001448,1,7,2,0,1,11
E02001449,0,8,0,1,1,10
E02001450,0,7,1,0,0,8
E02001451,0,13,2,0,0,15
E02001452,0,8,0,0,0,8
E02001453,0,8,0,1,0,9
E02001454,0,4,2,1,0,7
E02001455,0,3,1,0,0,4
E02001456,2,4,0,0,0,6
E02001457,2,4,2,0,0,8
E02001458,0,1,0,0,0,1
E02001459,0,1,0,0,0,1
E02001460,1,8,1,1,0,11
E02001461,0,4,1,1,0,6
E02001462,0,5,2,0,0,7
E02001463,0,5,0,2,0,7
E02001464,0,6,2,0,0,8
E02001465,0,8,4,1,0,13
E02001466,0,4,1,1,0,6
E02001467,0,10,1,0,0,11
E02001468,1,7,5,1,0,14
E02001469,1,6,0,0,0,7
E02001470,0,4,1,0,0,5
E02001471,0,2,0,0,0,2
E02001472,0,5,0,0,0,5
E02001473,0,11,2,0,0,13
E02001474,0,3,3,1,0,7
E02001475,1,9,4,0,0,14
E02001476,2,9,1,1,0,13
E02001477,0,9,3,0,0,12
E02001478,1,3,2,0,0,6
E02001479,0,0,1,0,0,1
E02001480,0,17,9,0,0,26
E02001481,1,3,2,1,0,7
E02001482,0,7,1,1,0,9
E02001483,0,3,2,1,0,6
E02001484,0,9,13,1,0,23
E02001485,0,5,0,0,0,5
E02001486,0,9,9,0,0,18
E02001487,2,5,0,1,0,8
E02001488,0,6,0,0,0,6
E02001489,1,2,1,2,0,6
E02001490,0,6,3,0,0,9
E02001491,1,11,6,1,0,19
E02001492,0,5,1,0,0,6
E02001493,0,14,2,0,0,16
E02001494,0,3,3,0,0,6
E02001495,0,2,2,0,0,4
E02001496,1,2,0,0,0,3
E02001497,2,11,0,1,0,14
E02001498,0,3,1,3,0,7
E02001499,1,4,2,6,6,19
E02001500,1,6,1,1,1,10
E02001501,1,6,0,0,0,7
E02001502,1,11,6,1,0,19
E02001503,0,10,1,1,0,12
E02001504,1,20,4,0,2,27
E02001505,2,4,1,2,0,9
E02001506,2,4,1,2,1,10
E02001507,0,9,2,0,0,11
E02001508,2,4,2,0,0,8
E02001509,0,4,6,2,0,12
E02001510,2,1,2,1,1,7
E02001511,0,5,6,0,0,11
E02001512,0,13,9,1,0,23
E02001513,0,3,2,0,0,5
E02001514,1,3,3,2,1,10
E02001515,0,2,2,0,0,4
E02001516,0,3,3,1,1,8
E02001517,0,1,0,0,0,1
E02001518,2,3,3,0,1,9
E02001519,0,1,2,5,0,8
E02001520,1,3,3,2,0,9
E02001521,0,2,1,0,0,3
E02001522,0,9,3,0,0,12
E02001523,0,2,2,2,0,6
E02001524,0,2,1,1,0,4
E02001525,0,3,11,0,0,14
E02001526,0,1,2,1,0,4
E02001527,0,4,0,1,0,5
E02001528,0,0,2,3,2,7
E02001529,0,12,3,0,0,15
E02001530,0,2,1,1,0,4
E02001531,1,5,3,1,0,10
E02001532,0,4,3,1,0,8
E02001533,0,5,4,0,0,9
E02001534,0,20,4,0,0,24
E02001535,0,1,2,1,0,4
E02001536,1,4,0,0,0,5
E02001537,0,1,1,0,0,2
E02001538,0,6,1,1,0,8
E02001539,0,0,1,0,0,1
E02001540,1,4,4,1,0,10
E02001541,0,8,11,2,0,21
E02001542,0,1,3,0,1,5
E02001543,0,8,5,1,0,14
E02001544,0,2,4,2,2,10
E02001545,0,1,2,1,0,4
E02001546,0,3,3,7,0,13
E02001547,0,4,3,1,1,9
E02001548,0,2,4,0,0,6
E02001549,0,1,2,1,0,4
E02001550,0,5,1,0,2,8
E02001551,0,1,0,1,0,2
E02001552,0,0,0,0,0,0
E02001553,0,3,5,0,0,8
E02001554,0,1,0,1,0,2
E02001555,0,1,0,2,0,3
E02001556,0,2,4,0,0,6
E02001557,0,7,7,1,0,15
E02001558,0,1,1,0,0,2
E02001559,0,1,1,1,0,3
E02001560,0,2,1,0,1,4
E02001561,0,11,3,1,0,15
E02001562,0,3,0,1,0,4
E02001563,0,9,2,1,0,12
E02001564,0,1,1,0,0,2
E02001565,0,2,1,2,0,5
E02001566,0,4,1,0,0,5
E02001567,0,2,0,2,0,4
E02001568,0,1,1,5,0,7
E02001569,0,4,2,0,1,7
E02001570,0,2,1,2,0,5
E02001571,0,4,0,1,1,6
E02001572,0,1,2,2,0,5
E02001573,0,5,1,1,0,7
E02001574,0,0,2,1,0,3
E02001575,1,5,5,3,0,14
E02001576,0,1,1,0,0,2
E02001577,0,3,2,4,1,10
E02001578,1,5,1,1,1,9
E02001579,0,9,1,1,1,12
E02001580,0,7,3,3,0,13
E02001581,0,10,0,1,0,11
E02001582,0,5,4,3,0,12
E02001583,0,1,1,0,0,2
E02001584,0,5,3,1,0,9
E02001585,0,5,4,2,0,11
E02001586,1,2,2,3,0,8
E02001587,0,3,2,0,0,5
E02001588,0,17,3,3,0,23
E02001589,0,4,2,0,0,6
E02001590,0,1,2,1,2,6
E02001591,0,4,1,0,1,6
E02001592,0,3,1,2,0,6
E02001593,0,3,0,0,1,4
E02001594,1,7,4,0,1,13
E02001595,0,3,2,1,0,6
E02001596,0,14,7,2,1,24
E02001597,0,6,3,0,1,10
E02001598,0,9,1,3,0,13
E02001599,0,5,3,4,0,12
E02001600,0,6,2,1,0,9
E02001601,1,5,2,4,1,13
E02001602,0,3,0,3,0,6
E02001603,0,3,2,1,0,6
E02001604,1,6,2,1,1,11
E02001605,0,5,4,2,0,11
E02001606,0,17,4,0,0,21
E02001607,0,4,3,0,1,8
E02001608,0,2,4,1,0,7
E02001609,0,8,3,2,0,13
E02001610,1,4,1,2,2,10
E02001611,0,7,16,0,0,23
E02001612,0,2,0,1,0,3
E02001613,0,3,4,0,0,7
E02001614,1,6,13,0,0,20
E02001615,0,8,1,0,0,9
E02001616,2,3,3,0,0,8
E02001617,0,9,0,0,0,9
E02001618,2,7,0,0,0,9
E02001619,2,2,0,0,1,5
E02001620,0,1,0,0,0,1
E02001621,0,8,3,1,0,12
E02001622,0,4,0,0,0,4
E02001623,2,8,5,1,1,17
E02001624,0,8,0,0,0,8
E02001625,0,7,1,0,0,8
E02001626,0,2,2,0,0,4
E02001627,0,0,1,0,0,1
E02001628,0,5,1,0,0,6
E02001629,0,17,5,0,0,22
E02001630,0,45,21,1,0,67
E02001631,2,4,3,0,0,9
E02001632,1,9,9,0,0,19
E02001633,1,3,0,0,0,4
E02001634,0,5,0,0,0,5
E02001635,1,1,1,0,0,3
E02001636,2,1,4,0,0,7
E02001637,0,3,0,1,0,4
E02001638,0,0,0,0,0,0
E02001639,0,4,2,2,0,8
E02001640,0,6,3,0,0,9
E02001642,1,4,2,1,0,8
E02001643,2,1,1,1,0,5
E02001646,0,2,2,0,0,4
E02001647,0,3,0,0,0,3
E02001648,0,1,1,0,0,2
E02001649,0,2,1,1,0,4
E02001650,1,5,0,0,0,6
E02001651,0,1,1,0,0,2
E02001652,0,1,0,0,0,1
E02001653,0,0,1,0,0,1
E02001654,0,17,2,0,0,19
E02001655,0,6,0,0,0,6
E02001656,0,1,2,0,0,3
E02001657,0,0,0,0,0,0
E02001658,0,1,1,0,1,3
E02001659,0,1,2,0,0,3
E02001660,0,5,3,1,0,9
E02001661,0,4,7,0,0,11
E02001662,0,6,13,1,0,20
E02001663,0,11,2,0,0,13
E02001664,0,7,2,0,0,9
E02001665,0,3,0,1,0,4
E02001666,0,2,0,0,0,2
E02001669,0,3,3,0,0,6
E02001670,0,15,1,0,0,16
E02001671,1,1,2,0,0,4
E02001672,2,1,2,0,0,5
E02001673,0,7,3,0,0,10
E02001674,2,12,4,0,1,19
E02001675,0,3,1,1,1,6
E02001676,0,3,0,0,0,3
E02001678,0,6,3,0,0,9
E02001679,0,7,1,0,0,8
E02001680,0,9,1,0,0,10
E02001681,1,2,3,0,0,6
E02001682,1,2,1,0,0,4
E02001683,0,24,7,0,0,31
E02001684,0,7,2,0,0,9
E02001685,0,6,0,1,0,7
E02001686,0,5,2,1,0,8
E02001688,0,13,1,1,0,15
E02001689,1,7,4,2,0,14
E02001690,1,1,1,0,0,3
E02001691,0,2,2,0,0,4
E02001692,0,4,0,0,0,4
E02001693,0,4,1,0,0,5
E02001694,0,1,1,0,0,2
E02001695,0,4,0,0,0,4
E02001696,0,5,4,0,0,9
E02001697,1,11,6,0,0,18
E02001698,0,7,1,0,0,8
E02001699,0,2,1,0,0,3
E02001700,0,2,0,0,0,2
E02001701,0,5,6,1,1,13
E02001702,1,3,1,0,0,5
E02001703,0,4,1,0,0,5
E02001704,0,1,3,0,0,4
E02001705,0,6,2,0,0,8
E02001706,1,8,1,0,0,10
E02001707,1,13,4,0,0,18
E02001708,1,5,2,0,0,8
E02001709,2,3,1,0,0,6
E02001710,1,13,6,1,0,21
E02001711,0,5,2,1,0,8
E02001712,0,8,2,2,1,13
E02001713,0,3,1,1,0,5
E02001714,0,1,1,0,0,2
E02001715,0,14,15,0,0,29
E02001718,0,5,1,0,0,6
E02001719,1,3,2,0,0,6
E02001720,0,4,2,0,0,6
E02001721,0,3,2,0,1,6
E02001722,1,5,1,0,0,7
E02001723,1,4,1,0,0,6
E02001724,1,3,6,4,0,14
E02001725,0,0,0,0,0,0
E02001726,0,5,0,0,0,5
E02001727,1,2,3,0,0,6
E02001728,1,3,1,0,0,5
E02001729,0,5,2,0,0,7
E02001730,0,3,0,0,0,3
E02001731,0,2,0,0,0,2
E02001732,0,0,0,0,0,0
E02001733,0,13,8,6,0,27
E02001734,1,9,6,1,0,17
E02001735,0,3,2,1,0,6
E02001736,0,3,2,0,0,5
E02001737,1,5,0,0,0,6
E02001738,0,1,3,0,0,4
E02001739,1,0,2,0,0,3
E02001740,0,1,0,0,0,1
E02001741,1,3,0,0,0,4
E02001742,0,3,0,0,0,3
E02001743,0,6,3,0,0,9
E02001744,0,1,3,0,0,4
E02001745,1,1,1,0,0,3
E02001746,0,4,5,0,0,9
E02001747,1,1,1,0,0,3
E02001748,0,3,4,0,0,7
E02001749,0,1,1,0,0,2
E02001750,0,4,6,1,0,11
E02001751,1,3,0,0,0,4
E02001752,0,4,1,0,0,5
E02001753,0,1,0,0,0,1
E02001754,2,5,5,2,0,14
E02001755,0,2,0,0,0,2
E02001756,1,0,1,0,0,2
E02001757,0,0,1,0,0,1
E02001758,0,1,0,1,0,2
E02001759,0,2,0,0,0,2
E02001760,0,4,0,0,0,4
E02001761,0,3,3,0,0,6
E02001762,0,0,1,0,0,1
E02001763,0,3,4,0,0,7
E02001764,0,3,1,0,0,4
E02001765,1,7,12,2,0,22
E02001766,0,1,1,0,0,2
E02001767,0,8,4,1,1,14
E02001768,0,4,6,0,0,10
E02001769,0,2,3,0,0,5
E02001770,0,5,0,1,0,6
E02001771,0,1,2,0,0,3
E02001772,0,2,3,0,1,6
E02001773,0,5,0,0,0,5
E02001774,0,6,6,0,0,12
E02001775,1,4,17,1,1,24
E02001776,1,18,1,1,0,21
E02001777,0,16,6,0,0,22
E02001778,0,7,1,0,0,8
E02001779,0,4,2,0,0,6
E02001780,1,2,0,1,0,4
E02001781,0,0,0,0,0,0
E02001782,0,1,4,0,0,5
E02001783,0,0,3,0,0,3
E02001784,1,1,1,0,0,3
E02001785,0,1,1,0,0,2
E02001786,1,1,1,1,0,4
E02001787,0,1,0,1,0,2
E02001788,0,2,9,0,0,11
E02001789,0,0,0,0,0,0
E02001790,0,2,0,0,0,2
E02001791,0,2,0,0,0,2
E02001792,2,2,1,0,0,5
E02001793,1,2,1,0,0,4
E02001794,1,24,3,0,0,28
E02001795,0,24,1,0,0,25
E02001796,0,7,1,0,0,8
E02001797,0,5,1,0,1,7
E02001798,0,11,1,0,0,12
E02001799,0,3,1,1,1,6
E02001800,1,3,0,0,0,4
E02001801,0,3,1,0,0,4
E02001802,1,11,2,0,0,14
E02001803,0,6,1,0,0,7
E02001804,2,8,12,0,0,22
E02001805,0,10,4,1,0,15
E02001806,0,7,1,0,0,8
E02001807,0,6,0,0,0,6
E02001808,0,3,0,0,0,3
E02001809,0,3,0,0,0,3
E02001810,1,3,0,0,0,4
E02001811,0,1,1,0,0,2
E02001812,0,14,5,0,0,19
E02001813,1,4,0,0,0,5
E02001814,0,4,3,1,0,8
E02001815,0,10,3,0,0,13
E02001816,0,11,1,0,0,12
E02001817,0,2,3,0,0,5
E02001818,0,1,2,1,0,4
E02001819,1,1,2,0,0,4
E02001820,0,6,1,1,0,8
E02001821,1,3,1,0,0,5
E02001822,1,6,9,0,0,16
E02001823,0,4,2,0,0,6
E02001824,0,7,0,0,0,7
E02001825,1,20,4,0,0,25
E02001826,2,7,2,0,0,11
E02001827,0,7,3,0,1,11
E02001828,0,10,0,0,0,10
E02001829,2,4,2,0,0,8
E02001830,1,4,1,0,0,6
E02001831,0,2,3,1,0,6
E02001832,2,4,0,0,0,6
E02001833,1,2,3,0,0,6
E02001834,0,0,2,0,0,2
E02001835,1,5,1,1,0,8
E02001836,4,5,3,2,0,14
E02001837,1,9,1,0,0,11
E02001838,3,12,1,3,1,20
E02001839,1,6,1,2,0,10
E02001840,0,11,3,1,0,15
E02001841,1,11,1,0,0,13
E02001842,0,7,4,0,0,11
E02001843,0,9,3,1,0,13
E02001844,4,25,1,0,0,30
E02001845,0,4,0,0,0,4
E02001846,1,3,2,0,0,6
E02001847,0,2,2,0,0,4
E02001848,2,6,4,1,0,13
E02001849,0,3,2,0,0,5
E02001850,2,4,1,0,0,7
E02001851,1,7,1,1,0,10
E02001852,2,4,2,0,0,8
E02001854,1,8,1,0,1,11
E02001855,1,17,3,1,1,23
E02001856,0,2,1,0,0,3
E02001857,2,7,3,0,0,12
E02001858,1,2,0,0,0,3
E02001859,2,5,1,0,0,8
E02001860,1,5,1,0,0,7
E02001861,6,8,0,0,1,15
E02001862,5,7,0,2,0,14
E02001863,1,7,0,1,0,9
E02001864,0,3,0,0,0,3
E02001865,4,6,1,0,0,11
E02001866,6,7,3,0,0,16
E02001867,3,5,1,0,0,9
E02001868,5,5,1,0,0,11
E02001869,4,8,1,0,0,13
E02001870,1,11,4,0,1,17
E02001871,3,9,1,0,0,13
E02001872,0,4,0,1,0,5
E02001873,1,4,3,0,0,8
E02001874,2,6,1,0,0,9
E02001875,2,5,2,1,0,10
E02001876,2,5,0,1,0,8
E02001877,1,11,1,0,1,14
E02001878,4,4,2,0,0,10
E02001879,4,6,6,2,0,18
E02001880,0,8,1,0,0,9
E02001881,2,5,1,0,0,8
E02001882,1,5,1,0,0,7
E02001883,3,4,0,1,0,8
E02001884,2,2,2,0,0,6
E02001886,3,2,2,0,0,7
E02001888,1,6,0,0,0,7
E02001889,3,7,3,0,0,13
E02001890,1,6,1,0,1,9
E02001892,1,11,0,0,0,12
E02001893,0,7,1,0,0,8
E02001895,3,20,7,1,0,31
E02001896,2,6,2,0,0,10
E02001897,1,2,1,1,0,5
E02001898,0,4,2,0,0,6
E02001899,1,14,1,1,0,17
E02001900,3,4,3,1,0,11
E02001901,2,4,1,0,0,7
E02001902,2,3,1,0,0,6
E02001903,0,6,0,0,0,6
E02001904,2,9,2,0,0,13
E02001905,1,8,4,0,1,14
E02001906,0,4,2,0,1,7
E02001907,0,6,0,0,0,6
E02001908,0,5,1,0,0,6
E02001909,1,8,1,0,0,10
E02001910,5,2,1,0,0,8
E02001911,2,3,1,0,0,6
E02001913,2,3,0,0,0,5
E02001914,0,13,0,2,1,16
E02001915,2,11,3,0,0,16
E02001916,0,3,3,0,0,6
E02001918,2,14,0,1,0,17
E02001919,4,7,4,0,0,15
E02001920,0,1,0,0,0,1
E02001921,1,8,0,0,0,9
E02001922,0,0,0,0,0,0
E02001923,2,3,0,0,1,6
E02001924,0,4,0,0,0,4
E02001925,1,3,0,1,0,5
E02001926,1,5,4,0,0,10
E02001927,4,8,0,0,0,12
E02001928,0,5,1,0,0,6
E02001929,1,5,0,1,0,7
E02001930,0,2,2,0,0,4
E02001931,0,3,1,0,0,4
E02001932,2,1,0,1,0,4
E02001933,2,5,0,0,0,7
E02001934,2,10,0,0,0,12
E02001935,3,5,3,1,0,12
E02001936,3,0,2,0,0,5
E02001937,0,11,2,1,0,14
E02001938,1,0,0,0,0,1
E02001939,1,7,5,0,0,13
E02001941,0,19,3,0,0,22
E02001942,1,9,3,0,0,13
E02001943,2,1,1,0,0,4
E02001944,1,6,1,0,1,9
E02001945,1,4,0,0,0,5
E02001946,2,4,3,0,0,9
E02001947,1,2,0,0,0,3
E02001948,0,7,1,0,0,8
E02001949,2,5,0,0,0,7
E02001950,2,4,1,0,0,7
E02001951,1,3,0,0,0,4
E02001952,3,3,0,0,0,6
E02001953,2,13,8,0,0,23
E02001954,1,1,1,0,0,3
E02001955,1,7,6,3,0,17
E02001956,1,1,1,0,0,3
E02001957,0,5,1,0,0,6
E02001958,1,3,3,0,0,7
E02001959,2,3,1,1,0,7
E02001961,1,2,0,0,0,3
E02001962,1,0,0,0,0,1
E02001963,1,4,2,1,0,8
E02001964,1,2,0,0,0,3
E02001965,0,0,1,0,0,1
E02001966,0,3,0,0,0,3
E02001967,1,9,1,1,0,12
E02001968,2,5,0,1,0,8
E02001969,0,7,4,2,0,13
E02001970,0,3,0,0,0,3
E02001971,0,2,3,0,0,5
E02001972,1,4,0,0,0,5
E02001973,1,5,2,0,0,8
E02001974,3,3,1,1,0,8
E02001975,1,4,3,0,0,8
E02001976,2,6,3,0,1,12
E02001977,0,1,1,0,0,2
E02001978,2,3,1,0,0,6
E02001979,1,2,7,0,0,10
E02001980,0,5,1,1,0,7
E02001981,1,2,0,0,0,3
E02001982,1,1,2,0,0,4
E02001983,0,2,0,0,0,2
E02001984,0,10,4,0,0,14
E02001985,1,1,0,0,0,2
E02001986,2,12,0,0,0,14
E02001987,0,1,0,0,0,1
E02001988,1,9,0,0,0,10
E02001989,0,1,1,0,0,2
E02001990,5,5,1,0,0,11
E02001991,1,8,0,0,1,10
E02001992,4,12,2,1,0,19
E02001993,1,5,1,0,0,7
E02001994,1,5,2,0,0,8
E02001995,0,10,2,0,0,12
E02001996,0,5,0,0,0,5
E02001997,1,5,1,0,0,7
E02001998,0,4,1,0,0,5
E02001999,0,2,0,0,0,2
E02002000,1,2,1,0,1,5
E02002001,1,3,2,0,0,6
E02002002,3,8,2,0,0,13
E02002003,1,10,0,0,0,11
E02002004,1,3,0,0,0,4
E02002005,2,2,0,1,0,5
E02002006,0,1,0,0,0,1
E02002007,2,8,1,0,0,11
E02002008,0,5,3,0,0,8
E02002009,0,2,0,0,0,2
E02002010,1,10,2,2,0,15
E02002011,0,3,1,0,0,4
E02002012,1,6,2,1,0,10
E02002013,0,7,3,0,0,10
E02002014,1,5,0,0,0,6
E02002015,2,6,1,0,0,9
E02002016,1,5,0,1,0,7
E02002017,3,6,2,0,0,11
E02002018,0,11,2,0,0,13
E02002019,1,4,0,0,0,5
E02002020,3,13,3,0,0,19
E02002021,0,5,3,2,0,10
E02002022,0,5,1,0,0,6
E02002023,2,0,1,0,0,3
E02002024,0,1,0,1,0,2
E02002025,0,3,0,0,0,3
E02002026,0,3,0,0,0,3
E02002027,1,0,0,0,0,1
E02002028,1,0,0,0,0,1
E02002029,0,3,5,1,1,10
E02002030,0,6,2,0,0,8
E02002031,0,2,0,1,0,3
E02002032,2,2,3,1,0,8
E02002033,1,4,0,0,0,5
E02002034,2,3,0,0,0,5
E02002035,0,10,2,0,0,12
E02002036,3,6,0,0,0,9
E02002037,1,4,2,0,0,7
E02002038,3,5,1,1,0,10
E02002039,0,3,2,1,0,6
E02002040,2,1,0,0,0,3
E02002041,1,1,1,5,1,9
E02002042,1,9,3,0,1,14
E02002043,2,5,2,1,0,10
E02002044,2,6,1,0,0,9
E02002045,0,7,2,1,0,10
E02002046,0,5,0,0,0,5
E02002047,5,20,6,2,0,33
E02002048,0,2,5,0,0,7
E02002049,2,2,1,0,0,5
E02002051,0,3,1,2,0,6
E02002052,0,8,1,0,0,9
E02002053,0,4,0,0,0,4
E02002054,0,5,0,0,0,5
E02002055,3,4,2,1,1,11
E02002056,0,4,3,1,0,8
E02002057,2,8,1,0,0,11
E02002058,0,10,5,0,0,15
E02002059,2,9,4,1,0,16
E02002060,2,2,1,1,0,6
E02002061,1,5,1,0,0,7
E02002062,1,16,3,0,0,20
E02002063,0,5,1,1,0,7
E02002064,1,3,1,1,0,6
E02002065,1,9,4,2,0,16
E02002066,0,8,1,3,1,13
E02002067,2,3,1,1,0,7
E02002068,5,7,3,0,1,16
E02002069,1,4,2,1,0,8
E02002070,2,13,3,1,1,20
E02002071,3,2,0,0,0,5
E02002072,2,8,1,0,0,11
E02002073,1,7,1,0,0,9
E02002074,1,3,0,0,0,4
E02002075,1,8,3,1,0,13
E02002076,1,2,3,0,0,6
E02002077,2,5,1,0,0,8
E02002078,1,4,0,0,0,5
E02002079,3,5,4,0,0,12
E02002080,0,3,1,0,0,4
E02002081,0,2,0,0,0,2
E02002082,0,7,1,0,0,8
E02002083,1,2,1,1,0,5
E02002084,0,5,3,0,0,8
E02002085,0,2,0,1,0,3
E02002086,0,5,0,0,0,5
E02002087,0,3,3,1,0,7
E02002088,3,7,0,0,1,11
E02002089,2,7,1,0,0,10
E02002090,0,2,1,0,0,3
E02002091,1,8,0,0,1,10
E02002092,0,6,5,1,0,12
E02002093,0,10,0,0,0,10
E02002094,0,6,0,0,0,6
E02002095,1,6,2,1,0,10
E02002096,2,16,1,1,0,20
E02002097,0,5,2,0,0,7
E02002098,0,5,0,1,0,6
E02002099,2,4,0,0,0,6
E02002101,0,5,2,0,0,7
E02002102,0,19,2,0,0,21
E02002103,4,7,2,0,0,13
E02002104,1,8,3,0,0,12
E02002105,1,13,0,0,0,14
E02002106,0,12,19,2,0,33
E02002107,0,3,0,0,1,4
E02002108,1,2,1,0,0,4
E02002109,1,8,1,1,0,11
E02002110,0,5,1,1,0,7
E02002111,1,8,4,0,0,13
E02002112,0,3,3,0,0,6
E02002113,1,2,2,0,0,5
E02002114,1,11,3,2,0,17
E02002115,1,5,4,0,0,10
E02002116,1,9,7,1,0,18
E02002117,0,1,2,0,0,3
E02002118,4,8,2,1,1,16
E02002119,0,5,0,0,0,5
E02002120,0,6,0,0,0,6
E02002121,0,12,3,1,1,17
E02002122,2,5,3,0,0,10
E02002123,1,2,1,0,0,4
E02002124,0,4,4,0,0,8
E02002125,0,8,2,0,0,10
E02002126,0,7,2,1,1,11
E02002127,2,1,4,1,1,9
E02002128,3,3,3,0,0,9
E02002129,1,3,2,2,0,8
E02002130,2,7,1,0,0,10
E02002131,0,4,0,0,0,4
E02002132,0,14,4,0,0,18
E02002133,1,3,1,0,0,5
E02002134,0,7,1,0,0,8
E02002135,3,6,0,2,0,11
E02002136,1,4,0,0,0,5
E02002137,2,10,3,0,0,15
E02002138,0,7,2,0,0,9
E02002139,1,12,1,0,0,14
E02002140,1,11,5,1,0,18
E02002141,2,2,1,0,0,5
E02002142,1,6,1,1,0,9
E02002143,1,10,1,2,0,14
E02002144,2,6,1,0,1,10
E02002145,0,4,0,0,0,4
E02002146,1,6,1,0,0,8
E02002147,2,15,4,0,0,21
E02002148,2,7,1,0,0,10
E02002149,6,3,0,1,0,10
E02002150,1,4,0,1,0,6
E02002151,3,1,0,0,0,4
E02002152,2,5,0,0,0,7
E02002153,2,5,1,3,0,11
E02002154,1,5,0,0,0,6
E02002155,1,5,1,0,0,7
E02002156,0,5,1,0,0,6
E02002157,2,6,1,2,0,11
E02002158,0,8,3,0,0,11
E02002159,1,2,2,0,0,5
E02002160,3,4,4,1,0,12
E02002161,1,3,0,1,0,5
E02002162,3,12,4,0,0,19
E02002163,2,7,1,0,0,10
E02002164,0,4,1,0,0,5
E02002165,1,8,2,1,0,12
E02002166,3,4,7,0,1,15
E02002167,3,5,1,0,0,9
E02002168,5,2,1,0,0,8
E02002169,2,10,3,2,0,17
E02002170,2,2,2,0,0,6
E02002171,1,3,0,0,0,4
E02002174,1,5,2,3,0,11
E02002175,0,7,1,0,0,8
E02002176,1,2,0,1,0,4
E02002177,1,4,1,0,0,6
E02002178,4,10,4,0,0,18
E02002179,2,2,1,0,0,5
E02002180,3,2,0,1,0,6
E02002181,1,4,1,0,0,6
E02002182,8,15,3,2,0,28
E02002183,0,3,2,2,0,7
E02002184,0,22,5,1,0,28
E02002185,0,1,1,0,0,2
E02002186,2,6,8,0,0,16
E02002187,3,0,0,0,0,3
E02002188,2,2,2,0,0,6
E02002189,2,7,5,1,0,15
E02002190,0,8,1,1,0,10
E02002191,1,3,1,0,0,5
E02002192,1,10,5,0,0,16
E02002193,0,2,3,1,0,6
E02002194,1,3,2,0,0,6
E02002195,0,0,1,0,0,1
E02002196,0,1,0,0,0,1
E02002197,0,15,11,0,0,26
E02002198,0,0,4,0,0,4
E02002199,0,2,0,2,0,4
E02002200,0,14,4,2,0,20
E02002201,0,7,3,2,0,12
E02002202,0,4,1,0,0,5
E02002203,0,4,0,0,0,4
E02002204,0,5,3,0,1,9
E02002205,0,3,2,0,0,5
E02002206,0,4,0,0,0,4
E02002207,1,3,3,1,1,9
E02002208,0,6,1,1,0,8
E02002209,1,1,1,0,0,3
E02002210,0,2,0,0,0,2
E02002211,0,3,2,0,1,6
E02002212,0,5,3,1,0,9
E02002213,0,5,0,0,0,5
E02002214,0,1,1,0,0,2
E02002215,0,1,3,4,0,8
E02002216,1,14,3,0,0,18
E02002217,0,12,2,1,0,15
E02002218,0,3,1,2,0,6
E02002219,0,4,1,1,3,9
E02002220,1,5,1,0,0,7
E02002221,0,3,2,2,2,9
E02002222,0,7,12,0,0,19
E02002223,0,0,2,0,1,3
E02002224,1,6,1,0,0,8
E02002225,0,3,1,0,0,4
E02002226,1,9,3,2,0,15
E02002227,0,1,1,1,0,3
E02002228,1,3,1,1,0,6
E02002229,0,2,1,1,0,4
E02002230,0,1,2,1,0,4
E02002231,2,8,5,3,1,19
E02002232,1,14,4,0,0,19
E02002233,0,5,3,0,0,8
E02002234,1,3,0,0,0,4
E02002235,0,3,1,0,0,4
E02002236,0,1,3,0,0,4
E02002237,1,2,0,0,0,3
E02002238,0,4,2,0,1,7
E02002239,0,2,1,0,0,3
E02002240,0,2,2,0,0,4
E02002241,0,2,10,7,0,19
E02002242,1,3,1,2,0,7
E02002243,2,3,0,0,0,5
E02002244,0,0,0,0,0,0
E02002245,0,0,0,1,0,1
E02002246,0,1,1,0,1,3
E02002247,0,4,0,1,0,5
E02002248,0,0,0,0,0,0
E02002249,0,0,0,0,0,0
E02002250,0,1,0,0,0,1
E02002251,3,7,2,0,0,12
E02002252,0,1,0,1,0,2
E02002253,0,3,1,0,0,4
E02002254,0,3,1,1,0,5
E02002255,1,6,1,0,1,9
E02002256,0,9,0,1,0,10
E02002257,0,2,0,0,2,4
E02002258,1,2,1,0,1,5
E02002259,0,6,3,0,0,9
E02002260,0,3,0,0,0,3
E02002261,1,3,1,0,0,5
E02002262,0,3,2,0,0,5
E02002263,0,1,0,0,0,1
E02002264,0,2,1,0,0,3
E02002265,0,3,0,0,0,3
E02002266,1,4,3,0,0,8
E02002267,0,5,0,0,0,5
E02002268,0,6,0,0,0,6
E02002269,0,4,2,0,1,7
E02002270,0,3,0,0,0,3
E02002271,0,4,1,0,0,5
E02002272,0,4,2,2,0,8
E02002273,3,4,9,1,0,17
E02002274,1,3,0,0,1,5
E02002275,0,3,1,0,0,4
E02002276,0,4,2,0,0,6
E02002277,0,8,2,0,0,10
E02002278,0,3,0,1,0,4
E02002279,0,1,1,1,0,3
E02002280,0,7,2,1,1,11
E02002281,0,1,1,0,0,2
E02002282,1,1,1,0,0,3
E02002283,0,6,1,0,1,8
E02002284,1,2,0,2,0,5
E02002285,1,1,6,1,1,10
E02002286,0,1,2,0,0,3
E02002287,1,3,9,0,1,14
E02002288,0,4,3,1,0,8
E02002289,0,0,0,0,0,0
E02002290,1,0,1,0,0,2
E02002291,1,3,1,0,1,6
E02002292,1,4,1,0,1,7
E02002293,0,3,0,0,0,3
E02002294,0,7,2,3,1,13
E02002295,0,1,2,0,0,3
E02002296,1,1,1,0,0,3
E02002297,0,1,0,0,0,1
E02002298,0,7,2,0,0,9
E02002299,0,0,0,0,0,0
E02002300,0,5,1,0,1,7
E02002301,0,2,1,1,0,4
E02002302,1,2,0,0,1,4
E02002303,0,6,1,1,0,8
E02002304,1,1,0,0,0,2
E02002305,1,1,1,0,0,3
E02002306,1,4,0,0,0,5
E02002307,1,1,0,0,0,2
E02002308,0,1,1,0,0,2
E02002309,0,8,1,0,0,9
E02002310,0,1,2,1,0,4
E02002311,0,0,1,0,0,1
E02002312,0,1,0,0,0,1
E02002313,0,4,3,1,1,9
E02002314,0,3,4,2,0,9
E02002315,0,1,0,0,0,1
E02002316,0,3,0,0,0,3
E02002317,0,3,0,0,0,3
E02002318,2,4,4,0,0,10
E02002319,0,2,1,0,0,3
E02002320,0,2,1,0,0,3
E02002321,0,6,2,0,0,8
E02002322,0,2,0,0,0,2
E02002323,1,3,1,0,0,5
E02002324,0,6,0,0,0,6
E02002325,0,12,1,2,0,15
E02002326,0,3,0,0,0,3
E02002327,0,6,3,1,0,10
E02002328,0,2,1,0,1,4
E02002329,0,2,1,0,0,3
E02002330,0,3,0,1,0,4
E02002331,0,3,7,3,1,14
E02002332,0,2,0,0,0,2
E02002333,0,4,0,0,1,5
E02002334,0,6,3,1,0,10
E02002335,1,3,0,0,0,4
E02002336,0,1,1,0,1,3
E02002337,1,2,4,1,0,8
E02002338,0,6,9,0,0,15
E02002339,1,3,0,0,0,4
E02002340,0,1,0,0,0,1
E02002341,1,6,3,0,1,11
E02002342,0,3,1,0,0,4
E02002343,0,1,0,0,0,1
E02002344,0,2,1,0,0,3
E02002345,0,2,2,0,0,4
E02002346,0,1,0,0,0,1
E02002347,0,2,1,0,0,3
E02002348,0,6,5,1,0,12
E02002349,0,12,7,0,0,19
E02002350,1,3,2,0,0,6
E02002351,0,3,2,1,0,6
E02002352,0,4,13,0,0,17
E02002353,1,3,2,1,0,7
E02002354,0,9,3,0,0,12
E02002356,0,0,4,1,0,5
E02002357,0,1,2,1,0,4
E02002358,0,2,0,0,0,2
E02002359,0,1,1,0,0,2
E02002360,0,2,0,0,0,2
E02002361,1,2,1,1,0,5
E02002362,1,3,2,0,0,6
E02002363,0,6,1,1,0,8
E02002364,1,15,9,0,0,25
E02002366,1,9,5,5,4,24
E02002367,0,5,0,0,0,5
E02002368,0,0,2,0,0,2
E02002369,0,0,1,0,0,1
E02002370,0,0,0,0,0,0
E02002371,0,7,4,0,0,11
E02002373,0,5,2,1,0,8
E02002374,0,3,0,0,0,3
E02002375,0,1,0,1,0,2
E02002376,0,7,4,0,0,11
E02002377,0,1,0,1,1,3
E02002379,1,2,0,0,0,3
E02002380,1,2,1,0,0,4
E02002381,0,1,0,0,0,1
E02002382,0,4,1,2,0,7
E02002383,0,1,0,0,0,1
E02002384,0,3,0,0,0,3
E02002385,0,2,0,1,0,3
E02002386,0,4,1,1,0,6
E02002387,1,5,1,0,0,7
E02002388,0,3,2,0,0,5
E02002389,1,4,1,1,0,7
E02002390,0,5,0,0,0,5
E02002391,0,2,0,0,0,2
E02002392,0,0,1,0,0,1
E02002393,0,3,1,1,0,5
E02002394,0,3,1,0,0,4
E02002395,0,12,1,1,0,14
E02002396,0,5,1,0,0,6
E02002397,0,5,3,0,0,8
E02002398,0,5,0,0,0,5
E02002399,0,4,1,0,1,6
E02002400,0,2,0,0,0,2
E02002401,0,2,1,0,0,3
E02002402,1,26,6,0,0,33
E02002403,1,5,2,1,0,9
E02002404,0,5,1,0,0,6
E02002405,0,11,5,0,0,16
E02002406,0,0,2,0,0,2
E02002407,0,2,1,1,0,4
E02002408,1,3,1,1,1,7
E02002409,0,5,0,0,0,5
E02002410,1,6,2,0,0,9
E02002411,0,12,2,1,0,15
E02002412,1,2,1,0,0,4
E02002414,0,3,9,2,1,15
E02002415,1,2,0,0,0,3
E02002416,1,4,0,0,0,5
E02002417,0,1,3,0,0,4
E02002418,0,4,0,0,0,4
E02002419,1,5,0,0,1,7
E02002420,0,3,2,1,0,6
E02002421,1,1,1,0,0,3
E02002422,2,7,2,0,0,11
E02002423,0,7,0,0,0,7
E02002424,3,5,1,0,0,9
E02002425,1,8,0,1,0,10
E02002426,0,7,2,0,0,9
E02002427,0,1,4,0,0,5
E02002428,1,1,0,0,0,2
E02002429,1,4,1,0,0,6
E02002430,1,4,4,0,0,9
E02002431,1,3,1,0,0,5
E02002432,0,11,5,0,1,17
E02002433,0,2,1,0,0,3
E02002434,0,10,3,1,0,14
E02002435,0,2,3,0,0,5
E02002436,1,4,2,0,0,7
E02002437,3,1,0,0,0,4
E02002438,0,0,4,0,0,4
E02002439,1,13,2,0,1,17
E02002440,0,4,2,1,0,7
E02002441,0,6,2,3,0,11
E02002442,1,2,5,0,0,8
E02002443,0,0,1,0,0,1
E02002444,0,4,0,0,0,4
E02002445,0,7,13,0,0,20
E02002446,1,6,1,0,1,9
E02002447,1,7,2,0,0,10
E02002448,0,1,2,0,0,3
E02002449,0,0,5,3,1,9
E02002450,0,2,1,0,0,3
E02002451,0,3,2,1,1,7
E02002452,0,5,3,0,0,8
E02002453,1,10,4,1,0,16
E02002454,0,4,6,7,1,18
E02002455,0,3,4,0,0,7
E02002456,0,0,0,0,0,0
E02002457,1,15,0,0,1,17
E02002458,0,1,1,1,0,3
E02002459,0,2,2,2,0,6
E02002460,0,5,4,0,1,10
E02002461,2,12,5,1,0,20
E02002462,1,1,0,0,0,2
E02002463,0,16,0,1,0,17
E02002464,0,2,0,0,0,2
E02002465,0,3,0,0,0,3
E02002466,3,3,2,0,0,8
E02002467,0,2,0,0,0,2
E02002468,1,0,1,0,0,2
E02002469,0,4,1,0,0,5
E02002470,0,6,3,0,0,9
E02002471,1,5,0,0,0,6
E02002472,0,3,0,0,0,3
E02002473,2,2,3,0,0,7
E02002474,1,5,1,1,0,8
E02002475,1,2,2,0,1,6
E02002476,0,4,2,0,0,6
E02002477,0,4,0,1,0,5
E02002478,0,0,1,1,0,2
E02002479,0,6,1,0,0,7
E02002480,1,8,1,1,0,11
E02002481,1,15,2,1,1,20
E02002482,0,2,2,0,1,5
E02002483,0,4,4,2,0,10
E02002484,0,4,10,1,1,16
E02002485,0,9,3,1,0,13
E02002487,0,3,1,1,0,5
E02002488,1,6,6,0,0,13
E02002489,1,2,0,0,0,3
E02002490,0,0,2,1,0,3
E02002491,0,10,3,0,0,13
E02002492,2,0,0,0,0,2
E02002493,1,5,3,1,0,10
E02002494,0,8,3,1,0,12
E02002496,3,9,4,1,1,18
E02002497,1,5,1,0,0,7
E02002498,0,6,5,1,0,12
E02002499,0,20,1,1,0,22
E02002500,1,3,1,0,0,5
E02002501,1,11,2,0,0,14
E02002502,3,3,2,0,0,8
E02002503,1,4,1,0,0,6
E02002504,0,5,3,0,0,8
E02002505,0,2,5,1,0,8
E02002506,0,7,9,0,0,16
E02002507,0,2,4,0,0,6
E02002508,0,2,0,0,0,2
E02002509,0,2,0,0,0,2
E02002510,0,2,0,1,0,3
E02002512,0,4,1,0,0,5
E02002513,1,15,6,2,0,24
E02002514,2,17,7,1,0,27
E02002515,0,3,8,2,0,13
E02002516,0,5,2,0,0,7
E02002517,1,1,0,1,0,3
E02002518,0,9,8,0,0,17
E02002519,0,8,3,1,0,12
E02002520,2,3,0,1,0,6
E02002521,0,4,12,4,1,21
E02002523,0,5,0,0,0,5
E02002524,0,0,1,0,0,1
E02002525,2,7,0,0,0,9
E02002526,0,2,1,1,0,4
E02002527,0,3,1,0,0,4
E02002529,0,0,0,0,0,0
E02002530,1,1,0,0,0,2
E02002532,0,2,1,0,0,3
E02002533,0,0,5,5,0,10
E02002534,0,1,1,1,0,3
E02002535,1,3,4,1,0,9
E02002536,1,1,5,3,0,10
E02002537,0,4,0,0,0,4
E02002538,0,2,6,0,0,8
E02002539,0,2,4,0,0,6
E02002540,0,0,1,1,0,2
E02002541,0,0,0,0,0,0
E02002542,0,2,4,0,0,6
E02002543,0,2,9,0,1,12
E02002544,0,3,3,1,0,7
E02002545,0,2,1,0,0,3
E02002546,0,0,5,2,1,8
E02002547,0,0,2,1,0,3
E02002548,0,8,6,4,2,20
E02002549,1,0,3,3,0,7
E02002550,0,1,2,1,0,4
E02002551,1,3,1,0,0,5
E02002552,1,1,2,0,0,4
E02002553,0,4,0,2,0,6
E02002554,2,1,1,1,0,5
E02002555,2,7,2,1,0,12
E02002556,0,2,1,0,0,3
E02002557,0,0,3,2,0,5
E02002558,0,3,2,0,1,6
E02002559,0,2,0,0,0,2
E02002560,1,0,0,0,0,1
E02002561,0,1,4,0,0,5
E02002562,0,2,11,0,0,13
E02002563,0,9,2,0,0,11
E02002564,1,4,2,0,0,7
E02002565,0,2,0,0,0,2
E02002566,0,2,1,0,0,3
E02002567,0,6,1,1,0,8
E02002568,1,3,2,4,0,10
E02002569,1,6,2,0,0,9
E02002570,0,6,1,2,0,9
E02002571,0,3,1,1,0,5
E02002572,0,1,1,0,0,2
E02002573,0,0,2,1,0,3
E02002574,0,1,0,0,1,2
E02002575,2,6,0,0,0,8
E02002576,0,3,2,5,0,10
E02002577,0,3,0,1,0,4
E02002578,0,2,1,0,0,3
E02002579,0,11,1,1,0,13
E02002580,0,6,1,1,0,8
E02002581,0,7,4,0,0,11
E02002582,1,1,1,1,0,4
E02002583,0,2,0,1,0,3
E02002584,0,5,1,0,0,6
E02002585,1,4,5,0,0,10
E02002586,0,3,3,0,0,6
E02002587,0,2,1,0,0,3
E02002588,0,17,9,8,0,34
E02002589,1,2,0,0,0,3
E02002590,0,5,2,0,0,7
E02002591,0,6,2,0,0,8
E02002592,1,5,2,1,0,9
E02002593,0,2,1,0,0,3
E02002594,0,1,1,1,0,3
E02002595,0,0,2,0,0,2
E02002596,0,0,0,0,0,0
E02002597,0,6,3,0,0,9
E02002598,0,5,4,1,0,10
E02002599,0,19,4,1,0,24
E02002600,0,3,3,1,0,7
E02002601,0,1,0,0,0,1
E02002602,0,3,3,0,0,6
E02002603,0,4,2,0,0,6
E02002604,0,10,1,0,0,11
E02002605,1,4,2,1,0,8
E02002606,0,17,16,0,0,33
E02002607,0,8,5,1,1,15
E02002608,3,21,2,0,0,26
E02002609,1,8,3,1,0,13
E02002610,0,5,2,2,0,9
E02002611,0,7,2,0,0,9
E02002612,0,1,0,2,0,3
E02002613,0,1,2,0,0,3
E02002614,0,4,1,0,0,5
E02002615,0,4,4,0,0,8
E02002616,0,1,1,0,0,2
E02002617,0,1,1,0,1,3
E02002618,0,3,5,0,0,8
E02002619,0,4,2,0,0,6
E02002620,0,2,0,0,1,3
E02002621,0,3,1,1,2,7
E02002622,0,6,2,0,0,8
E02002623,0,5,0,0,0,5
E02002624,0,7,1,0,0,8
E02002625,0,5,1,0,0,6
E02002626,1,5,2,1,0,9
E02002627,0,0,0,0,0,0
E02002628,0,1,1,2,0,4
E02002629,0,0,1,0,0,1
E02002630,1,6,2,1,0,10
E02002631,0,4,1,0,0,5
E02002632,0,2,1,0,0,3
E02002633,0,6,3,1,0,10
E02002634,1,4,3,2,0,10
E02002635,0,6,3,1,0,10
E02002636,0,4,4,1,1,10
E02002637,0,2,3,1,1,7
E02002638,0,2,4,0,0,6
E02002639,0,4,1,0,2,7
E02002640,0,2,2,1,0,5
E02002641,0,9,1,0,0,10
E02002642,0,6,2,1,0,9
E02002643,0,2,0,1,0,3
E02002644,1,4,5,2,1,13
E02002645,0,0,2,0,0,2
E02002646,0,7,4,1,0,12
E02002647,0,4,1,0,0,5
E02002648,0,1,1,2,0,4
E02002649,1,1,1,3,0,6
E02002650,0,2,3,0,0,5
E02002651,0,6,4,0,1,11
E02002652,0,1,13,1,0,15
E02002653,0,0,1,1,0,2
E02002654,0,1,1,1,0,3
E02002655,1,6,1,0,0,8
E02002656,0,3,4,0,0,7
E02002657,1,3,3,0,0,7
E02002658,0,1,2,2,2,7
E02002659,0,3,0,3,0,6
E02002660,0,2,1,1,1,5
E02002661,0,3,6,5,0,14
E02002662,0,6,4,3,0,13
E02002663,0,0,0,1,0,1
E02002664,0,0,1,0,0,1
E02002665,0,7,4,2,0,13
E02002666,0,0,3,1,0,4
E02002667,0,2,0,0,0,2
E02002668,2,1,1,0,0,4
E02002669,0,3,1,0,0,4
E02002670,0,1,4,1,2,8
E02002671,0,0,11,1,0,12
E02002672,0,5,13,0,1,19
E02002673,0,2,2,0,0,4
E02002674,0,2,0,0,0,2
E02002675,0,0,0,0,0,0
E02002676,0,4,3,0,0,7
E02002677,0,3,0,1,0,4
E02002678,0,4,6,5,1,16
E02002679,0,4,2,0,0,6
E02002680,0,2,0,2,0,4
E02002681,0,1,1,2,0,4
E02002682,0,1,4,2,1,8
E02002684,2,5,6,0,0,13
E02002685,0,6,3,1,0,10
E02002686,0,6,4,3,1,14
E02002687,0,1,4,0,0,5
E02002688,0,0,6,0,0,6
E02002689,0,4,6,0,1,11
E02002691,0,4,3,1,0,8
E02002692,0,6,3,0,0,9
E02002693,0,0,0,0,0,0
E02002694,0,1,1,0,0,2
E02002695,0,2,1,3,0,6
E02002696,0,3,1,0,0,4
E02002697,1,2,0,1,1,5
E02002698,0,2,2,1,0,5
E02002699,1,4,2,0,1,8
E02002700,0,4,1,1,0,6
E02002701,0,4,0,1,0,5
E02002702,1,5,2,2,0,10
E02002703,0,7,6,2,0,15
E02002704,0,0,0,2,0,2
E02002705,1,4,1,1,0,7
E02002706,0,1,8,2,0,11
E02002707,0,1,5,2,1,9
E02002708,0,5,0,0,0,5
E02002709,0,3,3,0,0,6
E02002710,0,0,1,0,0,1
E02002711,0,4,2,1,0,7
E02002712,0,9,8,4,0,21
E02002714,0,1,1,0,0,2
E02002715,0,7,2,3,0,12
E02002716,1,2,0,0,0,3
E02002717,1,4,2,1,1,9
E02002718,0,3,2,2,0,7
E02002719,0,3,13,4,1,21
E02002720,0,1,2,1,0,4
E02002721,0,0,1,1,0,2
E02002722,0,7,3,2,0,12
E02002723,0,2,0,1,1,4
E02002724,0,0,0,0,0,0
E02002725,1,9,1,1,0,12
E02002726,1,3,0,0,0,4
E02002727,0,0,0,0,0,0
E02002728,0,1,1,0,0,2
E02002729,0,0,0,0,0,0
E02002730,0,1,0,0,0,1
E02002731,0,0,1,0,0,1
E02002732,0,1,0,0,0,1
E02002733,0,0,0,0,0,0
E02002734,0,0,0,0,0,0
E02002735,0,0,0,0,0,0
E02002736,0,2,0,0,0,2
E02002737,1,2,1,0,0,4
E02002738,0,1,0,0,0,1
E02002739,1,1,0,0,0,2
E02002740,0,1,0,0,0,1
E02002741,1,0,0,0,0,1
E02002742,0,2,0,0,0,2
E02002743,0,2,0,0,0,2
E02002744,0,0,0,0,0,0
E02002745,1,2,3,0,0,6
E02002746,0,2,0,0,0,2
E02002747,0,1,0,0,0,1
E02002748,0,1,0,1,0,2
E02002749,0,3,1,0,1,5
E02002750,0,1,0,0,0,1
E02002751,0,1,2,0,0,3
E02002752,0,1,1,0,0,2
E02002753,0,4,4,0,0,8
E02002754,0,1,0,1,0,2
E02002755,0,5,8,0,0,13
E02002756,0,0,1,0,0,1
E02002757,0,2,7,1,0,10
E02002758,0,0,1,0,0,1
E02002759,0,3,1,1,0,5
E02002760,1,6,0,0,0,7
E02002761,0,3,0,0,0,3
E02002762,0,0,0,1,0,1
E02002763,0,4,0,0,0,4
E02002764,1,2,1,0,0,4
E02002765,0,3,3,0,0,6
E02002766,0,5,4,1,0,10
E02002767,0,2,2,0,0,4
E02002768,0,0,2,0,0,2
E02002769,0,2,3,1,0,6
E02002770,0,2,1,0,0,3
E02002771,0,0,0,0,0,0
E02002772,0,1,1,0,0,2
E02002773,0,2,2,1,0,5
E02002774,0,3,2,0,0,5
E02002775,0,2,3,0,1,6
E02002776,2,1,1,2,0,6
E02002777,0,2,0,0,0,2
E02002778,0,4,11,0,0,15
E02002779,0,3,5,2,0,10
E02002780,0,3,0,0,0,3
E02002781,0,9,5,1,1,16
E02002782,0,1,3,0,0,4
E02002783,0,9,1,0,0,10
E02002784,0,2,0,0,0,2
E02002785,0,10,9,1,1,21
E02002786,0,1,0,0,0,1
E02002787,0,3,1,0,0,4
E02002788,0,1,0,0,0,1
E02002789,0,1,5,1,0,7
E02002790,1,5,1,0,0,7
E02002791,0,5,3,0,2,10
E02002792,2,2,2,2,0,8
E02002793,0,9,0,0,0,9
E02002794,0,4,5,0,0,9
E02002795,0,7,1,0,0,8
E02002796,0,1,2,0,0,3
E02002797,1,2,1,2,0,6
E02002798,0,5,0,0,0,5
E02002799,1,4,3,0,0,8
E02002800,2,10,3,2,0,17
E02002801,1,4,0,0,0,5
E02002802,0,4,2,0,0,6
E02002803,0,3,2,1,0,6
E02002804,2,4,1,2,0,9
E02002805,1,1,1,1,0,4
E02002806,0,4,2,0,0,6
E02002807,0,6,2,1,0,9
E02002808,0,6,2,1,1,10
E02002809,0,8,5,0,1,14
E02002810,1,6,1,0,0,8
E02002811,1,5,2,0,0,8
E02002812,2,9,3,1,0,15
E02002813,2,16,1,2,1,22
E02002814,1,11,2,2,0,16
E02002815,0,3,0,0,0,3
E02002816,1,3,6,1,0,11
E02002817,1,8,0,0,1,10
E02002818,1,15,1,1,0,18
E02002819,1,3,1,3,0,8
E02002820,1,3,1,0,0,5
E02002821,0,7,8,1,0,16
E02002822,1,8,1,0,1,11
E02002823,0,5,2,1,0,8
E02002824,0,6,2,5,0,13
E02002825,1,23,6,3,1,34
E02002826,0,2,1,0,1,4
E02002827,0,2,2,0,0,4
E02002828,0,3,3,0,0,6
E02002829,0,5,3,1,0,9
E02002830,0,4,0,0,0,4
E02002831,1,10,2,2,0,15
E02002832,1,8,3,0,1,13
E02002833,1,6,3,0,1,11
E02002834,0,2,0,2,0,4
E02002835,0,4,7,2,1,14
E02002836,0,2,3,1,1,7
E02002837,0,2,1,1,3,7
E02002838,2,6,2,0,1,11
E02002839,0,2,2,0,0,4
E02002842,0,0,0,0,0,0
E02002843,0,7,4,1,0,12
E02002844,1,10,2,2,5,20
E02002845,0,5,0,2,1,8
E02002846,0,2,1,0,0,3
E02002847,0,5,1,3,2,11
E02002848,3,3,1,1,0,8
E02002849,0,8,7,2,0,17
E02002851,0,4,0,2,3,9
E02002852,1,2,1,1,1,6
E02002853,3,2,3,0,2,10
E02002854,0,3,4,0,0,7
E02002855,1,2,0,0,0,3
E02002856,2,5,2,0,0,9
E02002857,0,1,1,0,0,2
E02002858,0,12,1,1,0,14
E02002860,0,7,12,2,0,21
E02002861,0,1,0,0,0,1
E02002862,0,5,2,0,0,7
E02002863,0,0,0,0,0,0
E02002864,0,2,0,1,0,3
E02002865,0,6,5,1,0,12
E02002866,0,0,5,0,0,5
E02002867,0,1,2,1,0,4
E02002868,1,8,1,0,0,10
E02002869,1,1,0,0,0,2
E02002871,0,3,7,1,0,11
E02002872,2,2,3,1,0,8
E02002873,0,7,1,0,0,8
E02002874,0,2,0,0,0,2
E02002875,2,5,0,0,0,7
E02002876,0,6,3,0,0,9
E02002877,0,3,2,0,0,5
E02002878,0,2,0,0,0,2
E02002879,0,1,1,1,0,3
E02002880,0,5,1,0,0,6
E02002881,0,6,3,2,0,11
E02002882,1,7,3,1,0,12
E02002883,0,7,0,0,0,7
E02002884,0,1,1,0,0,2
E02002885,1,2,0,1,0,4
E02002886,0,4,0,0,0,4
E02002887,0,8,13,0,0,21
E02002888,0,4,1,2,0,7
E02002889,0,0,1,0,0,1
E02002890,0,7,1,0,0,8
E02002891,0,4,0,0,0,4
E02002892,0,3,0,1,0,4
E02002893,0,2,1,0,0,3
E02002894,1,9,1,0,0,11
E02002895,0,1,0,0,0,1
E02002896,2,1,1,1,0,5
E02002897,0,1,1,2,0,4
E02002898,0,1,0,0,0,1
E02002899,0,0,0,0,0,0
E02002901,0,4,0,0,0,4
E02002902,1,11,5,0,0,17
E02002903,0,4,1,1,0,6
E02002904,0,13,0,0,0,13
E02002905,0,3,1,0,0,4
E02002906,0,1,1,1,0,3
E02002907,0,1,1,0,0,2
E02002908,0,3,2,0,0,5
E02002909,1,5,3,1,0,10
E02002910,0,1,3,0,0,4
E02002911,0,0,9,1,0,10
E02002912,0,3,0,0,0,3
E02002913,2,1,0,0,0,3
E02002914,0,1,0,1,0,2
E02002915,0,3,2,1,0,6
E02002916,1,1,1,0,0,3
E02002917,0,1,0,0,0,1
E02002918,0,1,5,4,0,10
E02002919,0,4,8,0,1,13
E02002920,0,1,0,0,1,2
E02002921,0,1,2,0,0,3
E02002922,0,2,0,0,1,3
E02002923,2,0,3,0,0,5
E02002924,0,1,1,0,0,2
E02002925,1,3,5,0,0,9
E02002926,0,6,15,0,0,21
E02002927,0,1,2,0,0,3
E02002928,0,1,4,0,0,5
E02002929,0,1,1,1,0,3
E02002930,0,1,0,0,0,1
E02002931,1,1,0,0,0,2
E02002932,0,2,1,0,0,3
E02002933,0,3,2,1,0,6
E02002934,0,0,1,0,0,1
E02002935,0,0,3,1,0,4
E02002936,2,2,0,0,0,4
E02002937,0,4,0,1,0,5
E02002938,0,1,0,0,0,1
E02002939,0,5,4,0,0,9
E02002940,1,2,3,0,0,6
E02002941,0,3,1,0,0,4
E02002942,1,4,3,0,0,8
E02002943,0,3,5,0,0,8
E02002944,1,2,2,0,1,6
E02002945,0,1,0,0,0,1
E02002946,0,5,1,2,0,8
E02002947,0,4,0,0,0,4
E02002948,0,0,1,0,0,1
E02002949,1,5,3,0,0,9
E02002950,0,3,0,0,0,3
E02002951,0,1,4,0,0,5
E02002952,0,4,4,1,0,9
E02002953,1,2,1,1,0,5
E02002954,2,0,1,0,1,4
E02002955,0,2,1,0,0,3
E02002956,0,7,5,0,0,12
E02002957,0,2,4,0,0,6
E02002958,0,2,2,0,0,4
E02002959,0,8,3,1,0,12
E02002960,0,1,0,1,1,3
E02002961,0,0,2,0,0,2
E02002962,0,2,3,0,0,5
E02002963,1,1,2,0,0,4
E02002964,0,5,4,0,0,9
E02002965,0,7,1,1,0,9
E02002966,0,0,0,0,0,0
E02002967,0,3,8,7,1,19
E02002968,1,5,3,2,0,11
E02002969,1,1,1,0,0,3
E02002970,0,2,2,0,2,6
E02002971,0,0,1,0,0,1
E02002972,0,5,2,1,0,8
E02002973,0,0,2,1,0,3
E02002974,0,4,2,1,0,7
E02002975,0,0,2,0,0,2
E02002976,1,3,0,0,0,4
E02002977,0,1,1,1,0,3
E02002978,0,0,3,0,0,3
E02002979,0,0,1,1,0,2
E02002980,0,2,4,0,0,6
E02002981,0,3,1,4,0,8
E02002982,0,0,1,1,0,2
E02002983,0,1,0,0,0,1
E02002984,0,16,4,0,0,20
E02002985,1,5,1,1,0,8
E02002986,0,3,0,0,0,3
E02002987,1,3,0,0,0,4
E02002988,0,20,1,0,0,21
E02002989,1,10,2,0,0,13
E02002990,0,0,0,0,1,1
E02002991,1,1,0,0,0,2
E02002992,0,0,1,0,0,1
E02002993,0,0,0,0,0,0
E02002994,1,2,1,0,0,4
E02002995,0,0,0,0,0,0
E02002996,0,1,0,0,0,1
E02002997,0,3,0,0,0,3
E02002998,0,1,0,0,0,1
E02002999,1,0,0,0,0,1
E02003000,0,1,0,0,0,1
E02003001,1,1,0,1,0,3
E02003002,1,0,1,0,0,2
E02003003,0,1,0,0,0,1
E02003004,0,3,2,0,0,5
E02003005,0,2,0,0,0,2
E02003006,0,1,2,0,0,3
E02003007,1,6,2,1,0,10
E02003008,0,1,0,0,0,1
E02003009,1,0,0,0,0,1
E02003010,0,0,0,0,0,0
E02003011,0,0,0,0,0,0
E02003012,4,4,1,0,0,9
E02003013,0,9,4,0,0,13
E02003014,0,2,1,0,0,3
E02003015,0,3,0,0,0,3
E02003016,1,1,0,0,1,3
E02003017,0,3,1,0,0,4
E02003018,1,0,0,0,0,1
E02003019,0,7,1,2,0,10
E02003020,2,17,6,0,0,25
E02003021,0,7,4,0,0,11
E02003022,0,2,0,0,0,2
E02003023,2,7,1,0,0,10
E02003024,0,5,1,0,0,6
E02003025,0,1,0,0,0,1
E02003026,0,6,0,0,0,6
E02003027,1,1,0,0,0,2
E02003028,0,11,3,0,0,14
E02003029,0,0,0,0,0,0
E02003030,1,2,2,0,0,5
E02003031,0,1,0,0,0,1
E02003032,2,4,0,0,0,6
E02003033,0,6,0,0,0,6
E02003034,1,1,0,0,0,2
E02003036,0,2,1,0,0,3
E02003037,0,6,0,1,0,7
E02003038,0,5,0,0,0,5
E02003039,1,2,1,0,0,4
E02003040,0,7,2,1,0,10
E02003041,0,1,0,0,0,1
E02003043,0,0,1,0,0,1
E02003044,0,2,2,0,0,4
E02003045,0,0,0,0,0,0
E02003046,0,1,0,0,0,1
E02003047,0,2,0,0,0,2
E02003048,0,0,0,0,0,0
E02003049,0,1,0,0,0,1
E02003050,0,1,1,0,0,2
E02003051,1,1,2,0,0,4
E02003052,0,4,0,0,0,4
E02003053,0,0,1,0,0,1
E02003054,0,2,1,0,0,3
E02003055,0,2,1,0,0,3
E02003056,0,3,0,1,0,4
E02003057,0,2,0,0,0,2
E02003058,0,3,0,9,0,12
E02003059,0,1,0,1,1,3
E02003060,0,6,1,0,0,7
E02003061,0,2,1,0,0,3
E02003062,0,2,0,0,0,2
E02003063,0,3,0,1,0,4
E02003064,0,0,0,0,0,0
E02003065,1,1,1,0,0,3
E02003066,0,5,1,0,0,6
E02003067,0,0,0,0,0,0
E02003068,0,2,3,1,0,6
E02003069,0,1,3,1,1,6
E02003070,1,5,8,1,0,15
E02003071,0,2,6,3,0,11
E02003072,1,2,2,0,0,5
E02003073,0,2,2,0,0,4
E02003074,0,1,1,0,0,2
E02003075,0,1,0,0,0,1
E02003076,0,4,3,0,0,7
E02003077,0,2,1,0,0,3
E02003078,0,1,0,1,0,2
E02003079,1,1,1,2,0,5
E02003080,0,5,2,2,0,9
E02003081,0,3,0,2,0,5
E02003082,1,1,2,2,0,6
E02003084,0,3,5,0,0,8
E02003085,0,1,1,0,0,2
E02003086,0,3,5,0,0,8
E02003087,0,3,0,3,0,6
E02003088,0,5,9,1,0,15
E02003089,1,1,1,0,0,3
E02003090,2,9,2,0,0,13
E02003091,1,10,0,0,0,11
E02003092,0,2,0,0,0,2
E02003093,0,8,0,0,0,8
E02003094,0,2,1,0,0,3
E02003095,0,2,1,0,0,3
E02003096,0,0,0,0,0,0
E02003097,0,1,3,1,0,5
E02003098,0,0,0,0,0,0
E02003099,1,5,1,0,0,7
E02003100,1,3,2,0,1,7
E02003101,0,2,0,0,0,2
E02003102,0,3,0,0,0,3
E02003103,0,0,0,0,0,0
E02003104,0,1,0,0,0,1
E02003105,0,1,0,0,0,1
E02003106,2,4,0,1,0,7
E02003107,0,3,2,0,0,5
E02003108,0,0,1,0,0,1
E02003109,0,3,1,0,0,4
E02003110,0,7,4,0,0,11
E02003111,0,6,1,0,0,7
E02003112,1,0,0,0,0,1
E02003113,1,3,1,0,0,5
E02003114,0,3,1,0,0,4
E02003115,1,6,0,0,0,7
E02003116,1,2,12,3,0,18
E02003117,0,3,1,0,0,4
E02003118,2,1,6,0,0,9
E02003119,0,6,3,0,0,9
E02003120,0,1,0,0,0,1
E02003121,0,5,4,1,1,11
E02003122,0,2,0,0,0,2
E02003123,0,2,0,0,0,2
E02003124,0,0,0,0,0,0
E02003125,0,1,8,0,0,9
E02003126,0,0,0,0,0,0
E02003127,0,0,0,0,0,0
E02003128,0,2,2,1,0,5
E02003129,1,1,0,0,0,2
E02003130,1,0,1,2,0,4
E02003131,0,3,0,0,0,3
E02003132,1,1,0,0,0,2
E02003133,0,1,0,0,1,2
E02003134,0,2,0,0,0,2
E02003135,0,1,1,0,0,2
E02003136,0,6,1,0,0,7
E02003137,1,2,0,0,0,3
E02003138,0,0,0,0,0,0
E02003139,0,1,0,0,0,1
E02003140,0,2,1,0,0,3
E02003141,0,4,0,0,0,4
E02003142,0,1,1,0,0,2
E02003143,0,0,0,0,0,0
E02003144,0,0,0,0,0,0
E02003145,0,1,2,1,0,4
E02003146,0,1,0,0,0,1
E02003147,0,1,2,0,0,3
E02003148,0,1,2,0,0,3
E02003149,0,1,1,0,0,2
E02003150,0,4,1,1,0,6
E02003151,0,9,4,0,0,13
E02003152,0,1,0,0,0,1
E02003153,0,2,0,1,0,3
E02003154,0,1,2,0,0,3
E02003155,0,3,1,0,0,4
E02003156,0,2,1,0,0,3
E02003157,0,0,0,0,0,0
E02003158,1,1,1,0,0,3
E02003159,0,0,0,1,0,1
E02003161,1,4,0,0,0,5
E02003163,1,2,0,0,0,3
E02003164,0,0,0,0,0,0
E02003165,1,9,1,0,0,11
E02003166,0,1,0,0,0,1
E02003167,0,2,6,0,0,8
E02003168,0,3,0,0,0,3
E02003169,1,2,0,0,0,3
E02003170,0,5,1,0,0,6
E02003171,0,1,0,0,0,1
E02003172,1,5,2,0,0,8
E02003173,0,5,3,0,0,8
E02003174,0,2,0,1,0,3
E02003175,0,2,0,0,0,2
E02003176,0,4,0,0,0,4
E02003177,0,0,0,0,0,0
E02003178,0,2,1,1,1,5
E02003179,0,2,1,0,0,3
E02003180,0,4,0,0,0,4
E02003181,0,1,0,0,0,1
E02003182,0,6,0,0,0,6
E02003183,0,2,0,0,0,2
E02003184,0,0,0,0,0,0
E02003185,0,0,1,0,0,1
E02003186,0,1,0,0,0,1
E02003187,0,1,0,0,0,1
E02003188,0,2,0,0,0,2
E02003189,0,6,0,0,0,6
E02003190,0,3,0,0,0,3
E02003191,0,5,2,1,0,8
E02003192,1,5,0,0,0,6
E02003194,0,0,0,0,0,0
E02003195,0,1,2,0,0,3
E02003196,0,2,1,0,0,3
E02003197,0,2,0,0,0,2
E02003198,0,2,3,0,0,5
E02003199,0,4,0,0,0,4
E02003200,0,3,0,0,1,4
E02003201,0,1,0,0,0,1
E02003202,0,2,0,1,0,3
E02003203,0,1,0,0,0,1
E02003204,0,6,0,0,0,6
E02003205,1,0,1,0,0,2
E02003206,0,1,1,0,0,2
E02003207,0,4,0,0,0,4
E02003208,2,15,5,1,0,23
E02003209,0,0,0,0,0,0
E02003210,0,3,0,0,0,3
E02003211,1,14,4,0,0,19
E02003212,0,4,3,2,0,9
E02003214,0,1,0,1,0,2
E02003215,0,3,3,0,0,6
E02003216,1,3,0,0,0,4
E02003217,0,6,2,1,0,9
E02003218,0,2,2,0,0,4
E02003219,0,2,7,0,0,9
E02003220,0,14,1,1,0,16
E02003221,0,3,3,0,0,6
E02003222,0,0,1,0,0,1
E02003223,1,2,1,0,0,4
E02003224,0,4,1,0,0,5
E02003225,0,2,0,1,0,3
E02003226,0,5,1,0,0,6
E02003227,0,3,2,2,0,7
E02003228,1,3,1,0,0,5
E02003229,0,4,0,0,0,4
E02003230,0,5,0,0,0,5
E02003231,0,0,1,0,0,1
E02003232,0,2,0,0,0,2
E02003233,0,2,2,0,0,4
E02003234,0,3,1,0,0,4
E02003235,0,5,1,0,1,7
E02003236,0,16,10,0,0,26
E02003237,1,0,0,0,0,1
E02003238,0,0,0,0,0,0
E02003239,0,1,2,1,0,4
E02003240,0,0,0,0,0,0
E02003241,0,1,3,0,0,4
E02003242,0,1,2,1,0,4
E02003243,0,0,0,0,0,0
E02003244,0,1,0,0,0,1
E02003245,0,0,1,0,0,1
E02003246,0,4,0,0,0,4
E02003247,1,13,1,1,0,16
E02003248,0,3,4,4,0,11
E02003249,0,4,3,1,0,8
E02003250,0,5,2,0,2,9
E02003251,0,4,4,1,1,10
E02003252,0,3,4,1,0,8
E02003253,0,0,1,0,0,1
E02003254,1,1,1,0,0,3
E02003255,0,3,2,0,0,5
E02003257,0,1,1,0,0,2
E02003258,0,4,0,2,0,6
E02003259,1,3,1,2,0,7
E02003260,1,5,5,0,0,11
E02003261,1,12,3,1,0,17
E02003262,0,6,2,1,0,9
E02003263,1,8,1,1,0,11
E02003264,3,8,0,0,2,13
E02003265,1,7,3,3,0,14
E02003266,1,8,2,0,1,12
E02003267,0,8,2,0,0,10
E02003268,0,8,3,0,0,11
E02003269,0,7,3,0,0,10
E02003270,3,3,1,1,0,8
E02003271,0,4,0,1,0,5
E02003272,0,8,2,1,0,11
E02003273,2,4,2,0,0,8
E02003274,3,13,0,1,0,17
E02003275,1,6,5,1,0,13
E02003276,0,3,3,0,0,6
E02003277,1,4,2,0,0,7
E02003278,0,3,4,0,1,8
E02003279,2,5,3,4,0,14
E02003280,1,7,0,1,2,11
E02003281,1,10,4,1,0,16
E02003282,0,12,1,1,0,14
E02003283,0,7,1,4,0,12
E02003284,2,4,0,1,1,8
E02003285,1,3,1,0,0,5
E02003286,1,2,1,0,0,4
E02003287,1,9,6,2,1,19
E02003288,1,10,4,0,0,15
E02003289,0,2,7,1,0,10
E02003290,3,14,5,2,0,24
E02003291,1,7,3,0,0,11
E02003292,0,3,1,0,3,7
E02003293,0,9,9,1,1,20
E02003294,0,7,4,0,1,12
E02003295,1,2,1,1,0,5
E02003296,1,5,1,1,0,8
E02003297,1,2,1,1,0,5
E02003298,0,6,3,1,0,10
E02003299,0,5,0,0,0,5
E02003300,0,5,0,0,0,5
E02003301,1,4,1,3,1,10
E02003302,1,17,0,1,0,19
E02003303,2,4,2,1,1,10
E02003304,4,7,1,0,1,13
E02003305,1,5,0,0,0,6
E02003307,1,7,1,1,0,10
E02003308,0,2,1,1,0,4
E02003309,1,4,2,2,0,9
E02003310,1,0,0,0,1,2
E02003311,0,8,6,0,0,14
E02003312,0,3,0,0,0,3
E02003313,0,7,4,0,0,11
E02003314,1,7,2,0,0,10
E02003315,0,1,1,0,0,2
E02003316,1,4,1,0,1,7
E02003317,1,6,4,0,1,12
E02003318,0,1,2,0,0,3
E02003319,0,5,0,0,0,5
E02003320,0,1,1,0,0,2
E02003321,2,3,0,0,0,5
E02003322,0,1,1,0,0,2
E02003323,0,4,1,1,0,6
E02003324,1,2,1,0,0,4
E02003325,0,4,1,0,0,5
E02003326,0,3,1,0,0,4
E02003327,2,2,1,0,0,5
E02003328,2,2,1,1,0,6
E02003329,1,2,0,0,1,4
E02003330,0,0,1,0,0,1
E02003331,0,3,0,0,1,4
E02003332,0,14,6,1,0,21
E02003333,0,3,1,0,0,4
E02003334,0,2,0,0,0,2
E02003335,2,3,0,0,0,5
E02003336,1,2,0,0,0,3
E02003337,0,3,0,1,0,4
E02003338,0,4,1,0,0,5
E02003339,2,6,3,0,1,12
E02003340,1,4,3,0,0,8
E02003341,0,0,2,0,0,2
E02003342,2,1,0,2,0,5
E02003343,0,1,1,0,0,2
E02003344,1,1,0,0,0,2
E02003345,0,2,0,0,0,2
E02003346,0,3,2,0,0,5
E02003347,0,0,0,1,0,1
E02003348,0,6,5,2,0,13
E02003349,1,3,2,0,0,6
E02003350,2,2,0,0,0,4
E02003351,1,3,1,0,0,5
E02003352,0,2,1,0,0,3
E02003353,0,5,2,1,0,8
E02003354,1,4,0,0,0,5
E02003355,0,2,1,0,0,3
E02003356,0,3,1,0,0,4
E02003357,0,1,0,0,0,1
E02003358,1,4,0,0,0,5
E02003359,1,3,0,0,0,4
E02003360,1,2,3,1,0,7
E02003361,2,3,1,0,0,6
E02003362,0,4,1,0,0,5
E02003363,0,5,0,2,0,7
E02003364,0,2,1,1,0,4
E02003365,0,5,0,0,0,5
E02003366,0,3,0,0,0,3
E02003367,0,0,0,0,0,0
E02003368,0,1,0,0,0,1
E02003369,1,0,0,0,0,1
E02003370,0,1,0,0,0,1
E02003371,1,2,1,0,0,4
E02003372,1,5,1,0,0,7
E02003373,0,2,1,0,0,3
E02003374,0,2,1,0,0,3
E02003375,1,0,3,0,0,4
E02003376,0,4,1,0,0,5
E02003377,0,5,0,0,0,5
E02003378,0,8,4,0,0,12
E02003379,1,11,2,0,0,14
E02003380,1,2,1,1,0,5
E02003381,0,6,0,0,0,6
E02003382,0,25,4,0,1,30
E02003383,1,1,1,0,0,3
E02003384,3,7,0,0,0,10
E02003385,0,3,0,1,0,4
E02003386,0,2,2,0,0,4
E02003387,0,5,1,0,0,6
E02003388,0,3,1,0,0,4
E02003389,1,2,0,0,0,3
E02003390,0,2,0,0,0,2
E02003391,1,10,1,1,0,13
E02003392,0,4,0,0,0,4
E02003393,1,2,2,0,0,5
E02003394,0,19,3,1,0,23
E02003395,0,7,3,0,0,10
E02003396,0,4,2,2,0,8
E02003397,1,4,2,0,0,7
E02003398,0,2,0,0,0,2
E02003399,0,2,0,0,0,2
E02003400,0,8,7,0,0,15
E02003401,1,22,2,0,0,25
E02003402,1,3,2,1,0,7
E02003403,0,5,3,0,0,8
E02003404,1,3,6,2,0,12
E02003405,0,7,3,0,0,10
E02003406,0,8,1,0,0,9
E02003407,0,3,1,0,0,4
E02003408,0,7,1,0,0,8
E02003409,0,1,1,0,0,2
E02003410,2,8,0,0,1,11
E02003411,0,5,1,1,0,7
E02003412,2,2,0,0,1,5
E02003413,3,7,1,0,1,12
E02003414,2,5,4,0,0,11
E02003415,1,9,2,1,0,13
E02003416,2,4,2,0,0,8
E02003417,0,4,0,0,0,4
E02003418,2,11,3,0,0,16
E02003419,2,2,1,1,0,6
E02003420,1,2,0,0,0,3
E02003421,1,0,0,0,0,1
E02003422,3,10,0,0,0,13
E02003423,0,1,0,1,0,2
E02003424,1,2,0,1,0,4
E02003425,3,5,1,0,0,9
E02003426,0,11,2,0,0,13
E02003427,1,1,2,0,0,4
E02003428,2,4,1,0,0,7
E02003429,0,5,0,0,0,5
E02003430,1,0,0,0,0,1
E02003431,0,2,1,0,0,3
E02003432,0,2,1,0,0,3
E02003433,0,6,0,0,1,7
E02003434,1,5,7,0,0,13
E02003435,1,0,1,0,0,2
E02003436,0,3,0,0,0,3
E02003437,1,11,2,0,0,14
E02003438,2,18,5,1,0,26
E02003439,2,3,0,0,0,5
E02003440,1,4,1,1,0,7
E02003441,0,2,3,0,0,5
E02003442,0,0,1,0,0,1
E02003443,2,3,2,2,1,10
E02003444,0,6,0,0,0,6
E02003445,0,2,3,0,0,5
E02003446,1,4,3,0,1,9
E02003447,0,20,2,0,0,22
E02003448,1,3,3,0,0,7
E02003449,0,2,1,0,0,3
E02003450,0,3,1,1,0,5
E02003451,0,4,3,0,0,7
E02003452,0,3,1,0,0,4
E02003453,1,1,1,1,0,4
E02003454,1,15,8,0,0,24
E02003455,0,7,1,0,0,8
E02003456,0,6,1,0,0,7
E02003457,0,5,1,0,0,6
E02003458,1,3,1,1,0,6
E02003459,0,5,3,1,0,9
E02003460,1,3,0,0,0,4
E02003461,5,15,1,0,0,21
E02003462,0,1,0,1,0,2
E02003463,0,2,1,0,0,3
E02003464,0,2,0,0,0,2
E02003465,3,3,2,0,0,8
E02003466,0,1,0,0,0,1
E02003467,2,20,3,0,1,26
E02003468,0,1,0,0,0,1
E02003469,0,2,0,0,0,2
E02003470,1,1,0,0,0,2
E02003471,0,1,0,0,0,1
E02003472,0,0,1,1,0,2
E02003473,0,1,1,0,0,2
E02003474,0,5,0,0,0,5
E02003475,0,13,1,0,0,14
E02003476,0,4,0,0,0,4
E02003477,0,3,1,0,0,4
E02003478,0,3,0,0,0,3
E02003479,0,6,1,0,0,7
E02003480,0,1,0,1,0,2
E02003481,1,3,0,0,0,4
E02003482,1,11,1,0,0,13
E02003483,1,3,1,0,0,5
E02003484,0,0,2,0,0,2
E02003485,3,11,2,0,0,16
E02003486,1,1,0,0,0,2
E02003487,1,4,1,0,1,7
E02003488,0,5,0,0,0,5
E02003489,3,6,2,1,0,12
E02003490,2,3,3,0,0,8
E02003491,4,2,1,0,0,7
E02003492,0,1,1,1,1,4
E02003493,1,1,1,0,0,3
E02003494,0,1,4,0,0,5
E02003495,0,4,0,0,0,4
E02003496,1,3,2,0,0,6
E02003497,2,4,0,1,0,7
E02003498,0,3,1,0,0,4
E02003499,1,0,3,1,0,5
E02003500,0,0,1,0,1,2
E02003501,0,0,1,0,0,1
E02003502,0,4,0,0,0,4
E02003503,2,6,1,2,0,11
E02003504,0,6,0,0,0,6
E02003505,0,0,1,0,0,1
E02003506,1,1,6,0,0,8
E02003507,0,12,2,2,0,16
E02003508,0,0,0,0,0,0
E02003509,1,2,4,0,0,7
E02003510,0,0,1,1,0,2
E02003511,0,2,2,0,0,4
E02003512,0,0,0,0,0,0
E02003513,1,3,1,0,0,5
E02003514,1,1,0,0,0,2
E02003515,0,2,0,1,1,4
E02003516,0,0,1,0,1,2
E02003517,0,1,0,1,0,2
E02003518,0,6,1,0,0,7
E02003519,0,1,0,0,0,1
E02003520,0,2,1,1,0,4
E02003521,2,4,1,1,0,8
E02003522,0,9,1,1,0,11
E02003523,0,4,6,0,0,10
E02003524,1,3,0,0,0,4
E02003525,0,0,0,0,0,0
E02003526,0,6,0,0,0,6
E02003527,0,2,0,0,0,2
E02003529,0,3,0,0,0,3
E02003530,1,1,0,1,0,3
E02003531,0,3,0,0,0,3
E02003532,1,2,0,0,0,3
E02003533,1,5,0,0,0,6
E02003534,0,1,0,0,0,1
E02003535,1,2,2,0,0,5
E02003536,2,4,0,1,0,7
E02003537,1,1,1,0,0,3
E02003538,0,6,1,0,0,7
E02003539,1,2,0,0,0,3
E02003540,1,15,0,0,0,16
E02003541,0,3,1,0,0,4
E02003542,0,0,1,0,0,1
E02003543,2,4,0,0,1,7
E02003544,0,0,0,0,0,0
E02003545,1,0,0,0,0,1
E02003546,0,6,4,1,0,11
E02003547,0,0,0,0,0,0
E02003548,0,3,1,0,0,4
E02003549,0,2,3,0,0,5
E02003550,1,3,2,0,0,6
E02003551,0,2,1,0,0,3
E02003552,2,6,3,0,0,11
E02003553,0,0,0,0,0,0
E02003554,2,6,3,0,0,11
E02003555,0,4,2,0,0,6
E02003556,1,1,1,0,0,3
E02003557,1,2,1,0,1,5
E02003558,0,4,2,0,0,6
E02003559,0,5,0,1,0,6
E02003560,0,1,0,0,0,1
E02003561,2,5,2,1,0,10
E02003562,0,3,1,0,0,4
E02003563,1,4,0,0,1,6
E02003564,0,1,1,0,0,2
E02003565,0,1,0,0,0,1
E02003566,0,0,1,0,0,1
E02003567,0,4,1,0,0,5
E02003568,0,9,2,0,0,11
E02003569,0,1,1,0,0,2
E02003570,0,2,1,0,0,3
E02003571,0,5,7,4,0,16
E02003572,1,2,0,0,0,3
E02003573,0,3,2,0,0,5
E02003574,0,3,2,0,0,5
E02003575,3,3,0,0,0,6
E02003576,1,0,1,0,0,2
E02003577,0,1,1,0,0,2
E02003578,0,0,1,0,0,1
E02003579,0,13,2,1,0,16
E02003580,0,2,1,0,0,3
E02003581,0,2,5,1,1,9
E02003582,0,4,6,1,0,11
E02003583,1,0,1,0,0,2
E02003584,0,0,0,0,1,1
E02003585,0,2,3,0,0,5
E02003586,0,1,0,0,0,1
E02003587,0,3,1,0,0,4
E02003588,0,1,0,0,0,1
E02003589,0,1,0,0,0,1
E02003590,0,1,4,0,0,5
E02003591,0,1,0,0,0,1
E02003592,1,6,11,0,2,20
E02003593,0,1,0,0,0,1
E02003594,0,3,5,0,0,8
E02003595,1,2,0,0,0,3
E02003596,1,5,2,0,0,8
E02003597,0,0,0,0,0,0
E02003598,0,2,0,0,0,2
E02003599,0,5,1,3,0,9
E02003600,0,8,1,1,0,10
E02003601,0,4,2,0,0,6
E02003602,1,4,2,1,0,8
E02003603,0,6,6,7,0,19
E02003604,0,3,7,1,1,12
E02003605,0,9,2,2,1,14
E02003606,1,6,2,1,0,10
E02003607,0,9,1,2,0,12
E02003608,1,6,0,1,0,8
E02003609,0,10,4,1,1,16
E02003610,1,7,2,1,1,12
E02003611,0,4,1,2,0,7
E02003612,2,0,3,0,0,5
E02003613,2,1,1,1,0,5
E02003614,0,1,1,1,0,3
E02003615,1,4,1,0,0,6
E02003616,0,2,1,1,0,4
E02003617,1,2,1,3,0,7
E02003618,1,3,0,1,0,5
E02003619,0,5,5,2,0,12
E02003620,0,6,3,1,0,10
E02003621,2,3,0,0,1,6
E02003622,1,5,1,1,1,9
E02003623,2,3,4,1,1,11
E02003624,4,5,5,1,0,15
E02003625,2,8,11,4,3,28
E02003626,1,2,0,0,1,4
E02003627,0,8,2,3,0,13
E02003628,1,3,4,1,1,10
E02003629,0,2,6,0,1,9
E02003630,0,1,1,1,2,5
E02003631,0,4,2,0,0,6
E02003632,0,2,3,0,0,5
E02003633,1,1,5,3,0,10
E02003634,1,3,1,0,1,6
E02003635,0,2,0,1,0,3
E02003636,0,5,2,0,0,7
E02003637,1,3,1,2,0,7
E02003638,1,1,2,0,0,4
E02003639,0,1,4,3,0,8
E02003640,0,3,2,1,0,6
E02003641,0,3,1,0,0,4
E02003642,1,3,2,1,0,7
E02003643,1,1,3,0,0,5
E02003644,0,6,3,0,1,10
E02003645,1,2,2,0,0,5
E02003646,1,3,0,2,0,6
E02003647,1,12,3,1,0,17
E02003648,1,4,3,0,0,8
E02003649,0,2,0,0,0,2
E02003650,0,4,6,2,1,13
E02003651,0,6,0,0,2,8
E02003652,0,2,0,0,0,2
E02003653,0,0,0,0,1,1
E02003654,0,0,1,0,0,1
E02003655,0,2,1,0,0,3
E02003656,1,2,2,0,0,5
E02003657,0,6,1,0,0,7
E02003658,0,3,2,0,0,5
E02003659,1,3,1,0,0,5
E02003660,1,1,1,0,0,3
E02003661,1,0,1,0,0,2
E02003662,0,0,2,0,0,2
E02003663,0,7,4,0,0,11
E02003664,0,9,3,1,0,13
E02003665,0,1,0,0,0,1
E02003666,0,3,0,0,1,4
E02003667,1,5,0,0,0,6
E02003668,0,4,0,1,1,6
E02003669,0,1,1,1,0,3
E02003670,1,3,4,2,2,12
E02003671,0,2,1,0,0,3
E02003672,0,11,1,1,0,13
E02003673,0,17,3,1,1,22
E02003674,0,1,0,0,0,1
E02003675,0,7,3,1,0,11
E02003676,0,3,0,0,0,3
E02003677,2,4,0,0,0,6
E02003678,3,13,0,0,0,16
E02003679,0,1,0,0,0,1
E02003680,1,3,0,0,3,7
E02003681,2,16,5,0,0,23
E02003682,1,2,0,0,0,3
E02003683,3,1,0,0,0,4
E02003685,1,2,1,0,0,4
E02003686,2,9,2,0,0,13
E02003687,1,4,1,0,0,6
E02003688,1,4,0,0,0,5
E02003689,1,3,0,0,0,4
E02003690,3,2,2,0,0,7
E02003691,0,2,2,0,0,4
E02003692,2,3,3,2,0,10
E02003693,2,4,2,0,0,8
E02003694,1,2,1,0,0,4
E02003695,1,7,3,0,0,11
E02003696,0,3,5,1,1,10
E02003697,0,7,2,0,0,9
E02003698,0,0,0,0,0,0
E02003699,0,0,6,1,0,7
E02003701,0,4,2,1,2,9
E02003702,0,5,0,0,0,5
E02003703,1,4,2,0,0,7
E02003704,0,1,0,1,0,2
E02003705,0,1,0,2,1,4
E02003706,0,1,0,0,0,1
E02003707,0,2,1,0,0,3
E02003708,2,3,1,0,0,6
E02003709,1,1,1,0,0,3
E02003710,2,1,1,0,1,5
E02003711,0,4,0,0,0,4
E02003712,2,3,2,0,0,7
E02003713,2,6,0,0,0,8
E02003714,1,1,1,1,0,4
E02003715,0,1,0,0,0,1
E02003716,0,0,0,0,0,0
E02003717,1,5,3,1,0,10
E02003718,1,3,2,0,0,6
E02003719,0,22,3,0,0,25
E02003720,1,6,2,0,0,9
E02003721,0,10,6,2,0,18
E02003722,0,6,6,0,0,12
E02003723,0,0,0,0,0,0
E02003724,0,1,0,0,0,1
E02003725,0,0,0,0,0,0
E02003726,0,2,1,0,0,3
E02003727,0,3,2,0,0,5
E02003728,0,2,0,0,0,2
E02003729,0,2,0,0,0,2
E02003730,0,3,0,0,0,3
E02003731,0,1,1,0,0,2
E02003732,0,2,1,0,0,3
E02003733,0,4,3,1,0,8
E02003734,1,5,0,0,0,6
E02003735,0,1,1,0,0,2
E02003736,0,2,1,0,0,3
E02003737,0,3,1,0,0,4
E02003738,0,0,0,0,0,0
E02003739,0,2,0,0,0,2
E02003740,0,13,6,0,0,19
E02003742,0,5,3,0,0,8
E02003743,2,2,2,1,1,8
E02003744,2,3,3,1,0,9
E02003745,0,7,0,0,0,7
E02003746,0,3,1,0,0,4
E02003747,0,5,0,0,1,6
E02003748,0,4,4,1,0,9
E02003749,0,0,7,0,0,7
E02003750,0,4,8,1,0,13
E02003751,0,2,4,1,0,7
E02003752,0,0,2,1,0,3
E02003753,0,2,1,0,0,3
E02003754,0,1,0,1,0,2
E02003755,0,2,9,0,0,11
E02003756,0,0,1,1,0,2
E02003757,1,1,3,1,0,6
E02003758,0,1,7,1,0,9
E02003759,0,2,2,0,0,4
E02003760,1,3,2,0,0,6
E02003761,0,10,3,4,1,18
E02003762,0,4,4,0,1,9
E02003763,1,2,1,0,0,4
E02003764,1,5,2,1,1,10
E02003765,0,3,1,1,0,5
E02003766,0,2,0,1,0,3
E02003767,0,1,0,0,0,1
E02003768,1,2,4,1,0,8
E02003769,0,2,0,1,0,3
E02003770,1,1,4,0,1,7
E02003771,0,2,1,1,0,4
E02003772,1,0,1,0,0,2
E02003773,0,3,4,1,0,8
E02003774,1,4,1,0,0,6
E02003775,0,0,1,1,0,2
E02003776,0,0,0,0,0,0
E02003777,0,2,0,0,0,2
E02003778,0,0,2,0,0,2
E02003779,0,0,0,0,0,0
E02003780,0,4,1,1,0,6
E02003781,0,0,0,1,0,1
E02003783,1,0,0,0,0,1
E02003784,1,7,2,0,0,10
E02003785,0,2,1,0,0,3
E02003786,0,0,1,2,0,3
E02003787,1,2,0,1,0,4
E02003788,0,4,1,0,0,5
E02003789,0,4,0,0,0,4
E02003790,0,4,1,0,0,5
E02003791,0,1,0,0,0,1
E02003792,0,3,0,0,0,3
E02003793,0,3,0,0,0,3
E02003794,0,3,4,1,1,9
E02003795,0,15,10,4,0,29
E02003796,0,5,1,3,3,12
E02003797,1,12,0,3,1,17
E02003798,0,10,2,1,0,13
E02003799,0,7,1,4,2,14
E02003800,0,2,9,2,0,13
E02003801,0,4,3,0,1,8
E02003802,0,7,2,3,0,12
E02003803,0,7,2,0,0,9
E02003804,1,3,3,1,0,8
E02003805,0,4,2,2,0,8
E02003806,0,2,2,2,1,7
E02003807,1,7,0,0,0,8
E02003808,0,2,1,1,0,4
E02003809,0,3,2,0,0,5
E02003810,0,1,2,1,0,4
E02003811,0,1,1,1,0,3
E02003812,0,7,3,1,1,12
E02003813,0,12,4,0,1,17
E02003814,1,7,2,0,0,10
E02003815,1,6,7,0,0,14
E02003816,1,4,6,1,0,12
E02003817,0,3,1,1,0,5
E02003818,0,2,8,4,0,14
E02003819,0,7,2,2,0,11
E02003820,0,4,2,1,0,7
E02003821,1,4,1,0,0,6
E02003822,1,2,4,0,0,7
E02003823,0,3,2,3,0,8
E02003824,0,4,2,1,0,7
E02003825,0,1,0,2,0,3
E02003826,0,9,10,1,0,20
E02003827,0,6,8,1,0,15
E02003828,0,5,2,1,0,8
E02003829,1,2,1,1,0,5
E02003830,1,4,5,7,0,17
E02003831,3,8,4,8,2,25
E02003832,0,2,1,0,0,3
E02003833,0,1,3,0,0,4
E02003834,0,6,2,1,0,9
E02003835,0,3,0,0,0,3
E02003836,1,3,4,1,1,10
E02003837,1,10,5,1,1,18
E02003838,0,3,1,2,1,7
E02003839,0,5,4,2,0,11
E02003840,0,5,5,1,1,12
E02003841,1,4,2,0,0,7
E02003842,0,5,1,1,1,8
E02003843,0,2,2,1,0,5
E02003844,0,3,2,1,0,6
E02003845,0,7,4,2,0,13
E02003846,1,8,1,0,0,10
E02003847,2,6,1,2,0,11
E02003848,0,4,0,2,0,6
E02003849,0,0,2,4,1,7
E02003850,0,3,2,0,1,6
E02003851,0,4,2,2,0,8
E02003852,0,2,1,2,0,5
E02003853,0,3,1,0,1,5
E02003854,1,4,1,1,0,7
E02003855,1,23,7,1,0,32
E02003856,0,9,1,1,0,11
E02003857,2,3,2,0,0,7
E02003858,0,3,1,1,0,5
E02003859,3,14,8,4,1,30
E02003860,0,1,1,2,0,4
E02003861,0,6,3,4,1,14
E02003862,2,13,4,1,0,20
E02003863,0,9,0,1,0,10
E02003864,1,7,7,1,0,16
E02003865,0,2,5,0,0,7
E02003866,1,4,1,0,0,6
E02003867,0,3,2,3,0,8
E02003868,2,5,1,1,1,10
E02003869,0,11,10,1,1,23
E02003870,0,5,1,2,0,8
E02003871,0,4,3,2,0,9
E02003872,0,7,4,1,0,12
E02003873,0,0,4,2,0,6
E02003874,0,7,5,0,0,12
E02003875,0,1,4,0,1,6
E02003876,0,2,2,0,0,4
E02003877,0,12,2,3,1,18
E02003878,0,10,5,1,1,17
E02003879,1,7,6,0,0,14
E02003880,0,5,0,0,1,6
E02003881,0,1,1,1,0,3
E02003882,1,3,3,0,0,7
E02003883,0,4,3,0,0,7
E02003884,0,8,0,0,0,8
E02003885,0,1,2,0,0,3
E02003886,2,6,3,0,1,12
E02003887,1,1,3,2,0,7
E02003888,1,4,4,0,0,9
E02003889,0,3,1,0,0,4
E02003890,0,0,2,0,0,2
E02003891,0,0,1,0,0,1
E02003892,0,4,0,0,0,4
E02003893,1,1,0,0,0,2
E02003894,0,8,0,0,0,8
E02003895,0,2,2,1,0,5
E02003896,0,1,0,1,0,2
E02003897,0,1,0,0,0,1
E02003898,0,0,2,0,0,2
E02003899,0,0,0,0,0,0
E02003900,2,1,1,0,0,4
E02003901,0,1,7,1,0,9
E02003902,0,0,0,0,0,0
E02003903,0,0,0,0,0,0
E02003904,0,1,3,0,0,4
E02003905,0,0,0,0,0,0
E02003906,0,2,0,0,0,2
E02003907,1,3,0,0,0,4
E02003908,1,1,0,0,0,2
E02003909,0,2,0,0,0,2
E02003910,0,2,0,0,0,2
E02003911,0,1,1,0,0,2
E02003912,0,13,1,0,0,14
E02003913,1,1,0,0,0,2
E02003914,0,1,0,0,0,1
E02003915,0,1,0,0,0,1
E02003916,1,3,0,0,0,4
E02003917,0,1,1,0,0,2
E02003918,0,3,0,0,0,3
E02003919,1,0,0,0,0,1
E02003920,0,0,1,0,0,1
E02003921,0,0,0,0,0,0
E02003922,1,0,1,0,1,3
E02003923,1,2,1,0,0,4
E02003924,0,5,0,0,0,5
E02003925,1,1,0,0,0,2
E02003926,0,4,0,1,0,5
E02003927,0,1,0,0,0,1
E02003928,0,8,1,0,0,9
E02003929,0,2,0,0,0,2
E02003930,0,2,0,0,0,2
E02003931,0,1,0,0,0,1
E02003932,0,1,1,0,0,2
E02003933,0,0,0,0,0,0
E02003934,0,1,1,0,0,2
E02003935,0,3,2,0,0,5
E02003936,0,1,0,0,0,1
E02003937,0,1,0,0,0,1
E02003938,0,1,0,0,0,1
E02003939,0,1,1,0,0,2
E02003940,0,0,0,0,0,0
E02003941,1,1,1,0,0,3
E02003942,0,0,1,0,0,1
E02003943,1,2,1,0,0,4
E02003944,1,4,0,0,0,5
E02003945,1,5,3,0,0,9
E02003946,2,2,0,0,0,4
E02003947,1,3,2,0,0,6
E02003948,0,2,0,0,0,2
E02003949,0,1,0,0,0,1
E02003950,0,2,0,0,0,2
E02003951,0,0,2,0,0,2
E02003952,0,1,1,0,0,2
E02003953,0,1,0,0,0,1
E02003954,0,2,0,0,0,2
E02003955,0,3,0,0,0,3
E02003956,1,0,0,0,0,1
E02003957,0,2,0,0,0,2
E02003958,2,2,0,0,0,4
E02003959,1,4,0,0,0,5
E02003960,1,1,1,0,0,3
E02003961,2,0,0,0,0,2
E02003962,2,1,1,0,0,4
E02003963,0,5,0,0,0,5
E02003964,0,2,1,0,0,3
E02003965,0,5,1,0,1,7
E02003966,0,2,0,0,1,3
E02003967,1,0,0,2,1,4
E02003968,0,6,0,1,2,9
E02003969,0,3,0,0,0,3
E02003970,1,6,1,0,0,8
E02003971,3,2,1,0,0,6
E02003972,1,2,1,0,0,4
E02003973,2,2,0,0,0,4
E02003974,0,5,7,0,1,13
E02003975,0,3,0,1,0,4
E02003976,0,3,4,1,1,9
E02003977,1,2,0,0,0,3
E02003978,0,1,4,0,0,5
E02003979,1,9,0,2,0,12
E02003980,0,5,0,0,1,6
E02003981,0,2,0,0,0,2
E02003982,0,14,2,0,0,16
E02003983,2,5,1,0,1,9
E02003984,1,8,2,0,0,11
E02003985,2,3,1,0,1,7
E02003986,2,5,1,0,0,8
E02003987,1,5,1,0,0,7
E02003988,3,2,1,1,4,11
E02003989,0,2,1,0,0,3
E02003990,2,6,4,1,0,13
E02003991,1,12,5,0,0,18
E02003992,0,3,1,0,0,4
E02003993,2,1,4,0,0,7
E02003994,0,9,1,1,0,11
E02003995,0,6,3,0,0,9
E02003996,1,4,8,0,0,13
E02003997,3,5,15,1,0,24
E02003998,0,1,2,2,0,5
E02003999,1,5,0,1,0,7
E02004000,0,1,0,0,0,1
E02004001,2,2,0,3,0,7
E02004002,0,7,4,1,0,12
E02004003,0,14,3,1,0,18
E02004004,1,3,4,1,0,9
E02004005,0,1,1,1,0,3
E02004006,1,2,0,0,0,3
E02004007,1,7,1,0,0,9
E02004008,1,1,3,0,0,5
E02004009,0,0,3,1,0,4
E02004010,0,5,3,0,1,9
E02004011,1,4,2,0,0,7
E02004012,0,5,2,0,1,8
E02004013,1,2,0,1,0,4
E02004014,1,4,0,1,0,6
E02004015,0,5,1,0,0,6
E02004016,1,7,2,0,0,10
E02004017,1,3,0,0,0,4
E02004018,0,3,1,0,0,4
E02004019,0,13,6,0,0,19
E02004020,2,14,3,1,0,20
E02004021,2,5,4,0,0,11
E02004022,2,3,0,0,0,5
E02004023,1,1,1,1,0,4
E02004024,0,2,0,0,0,2
E02004025,1,4,0,0,0,5
E02004026,3,17,4,2,0,26
E02004027,6,9,8,2,0,25
E02004028,0,8,1,0,0,9
E02004029,0,3,2,0,0,5
E02004030,0,5,2,0,0,7
E02004031,1,6,0,2,0,9
E02004032,0,4,0,5,0,9
E02004033,1,2,2,0,0,5
E02004034,0,4,1,0,1,6
E02004035,1,2,0,1,0,4
E02004036,1,5,1,2,0,9
E02004037,1,4,1,0,0,6
E02004038,0,8,5,3,0,16
E02004039,1,3,0,0,0,4
E02004040,0,0,4,0,0,4
E02004041,1,2,0,0,0,3
E02004043,0,2,1,0,0,3
E02004044,0,4,3,0,0,7
E02004045,0,5,4,1,0,10
E02004046,0,4,1,0,0,5
E02004047,1,3,2,0,0,6
E02004048,0,0,2,0,0,2
E02004049,0,2,3,0,1,6
E02004050,0,3,5,1,0,9
E02004051,1,6,1,0,0,8
E02004052,0,1,1,0,0,2
E02004053,1,0,1,0,0,2
E02004054,2,2,1,0,0,5
E02004055,0,3,5,1,0,9
E02004056,1,7,3,0,0,11
E02004057,0,2,2,0,0,4
E02004058,0,2,1,0,1,4
E02004059,0,6,5,3,0,14
E02004060,0,2,6,0,0,8
E02004061,1,2,3,0,0,6
E02004062,0,7,1,0,0,8
E02004063,0,2,1,0,0,3
E02004064,0,2,0,0,0,2
E02004065,0,2,0,0,0,2
E02004066,1,5,6,2,0,14
E02004067,0,1,0,0,0,1
E02004068,0,5,1,0,0,6
E02004069,0,3,1,0,0,4
E02004070,0,5,6,0,1,12
E02004071,1,1,0,0,0,2
E02004072,1,12,1,8,0,22
E02004073,1,4,1,0,1,7
E02004074,1,3,1,0,0,5
E02004075,0,1,4,0,0,5
E02004076,0,5,2,2,0,9
E02004077,1,3,3,0,0,7
E02004078,1,3,2,1,0,7
E02004080,1,2,6,2,4,15
E02004081,1,3,0,2,0,6
E02004082,0,5,5,3,1,14
E02004083,0,4,2,1,1,8
E02004084,1,2,0,2,0,5
E02004085,1,5,1,0,0,7
E02004086,0,1,0,2,0,3
E02004087,0,1,0,0,0,1
E02004088,3,7,3,2,0,15
E02004089,0,5,1,2,0,8
E02004090,0,2,2,1,0,5
E02004091,1,4,2,0,0,7
E02004092,0,3,0,1,0,4
E02004093,0,13,0,0,0,13
E02004094,0,0,1,1,0,2
E02004095,1,6,3,0,2,12
E02004096,0,4,3,3,0,10
E02004097,1,1,1,0,1,4
E02004098,0,12,1,1,0,14
E02004100,0,5,2,1,0,8
E02004102,0,14,5,3,0,22
E02004103,0,2,1,1,0,4
E02004104,0,1,0,1,0,2
E02004105,0,13,2,0,0,15
E02004106,1,2,3,1,0,7
E02004108,1,14,9,2,1,27
E02004109,1,1,7,1,0,10
E02004110,1,2,2,2,0,7
E02004111,0,0,0,0,0,0
E02004112,1,1,5,1,0,8
E02004113,1,3,4,1,1,10
E02004114,1,5,4,0,0,10
E02004115,0,3,3,0,1,7
E02004116,2,5,6,0,0,13
E02004117,0,12,3,0,0,15
E02004118,1,8,3,1,0,13
E02004119,2,4,2,0,0,8
E02004120,0,6,0,0,0,6
E02004121,1,2,1,1,1,6
E02004122,0,8,2,0,0,10
E02004123,1,5,5,0,0,11
E02004124,3,8,1,0,0,12
E02004125,0,6,5,2,0,13
E02004126,0,4,1,0,0,5
E02004128,0,9,2,1,1,13
E02004129,0,0,0,0,0,0
E02004130,0,1,0,0,0,1
E02004131,0,1,1,0,0,2
E02004132,0,0,0,1,0,1
E02004133,0,5,5,0,0,10
E02004134,0,0,0,1,0,1
E02004135,0,1,0,0,0,1
E02004136,0,1,0,0,0,1
E02004137,0,0,1,0,0,1
E02004138,0,9,1,1,0,11
E02004139,0,0,1,0,0,1
E02004140,0,5,0,1,0,6
E02004141,0,0,0,0,0,0
E02004142,0,1,0,0,0,1
E02004143,0,0,0,0,0,0
E02004144,0,0,2,0,0,2
E02004145,0,1,1,1,0,3
E02004146,0,0,0,0,0,0
E02004147,0,1,0,0,0,1
E02004148,1,3,2,0,0,6
E02004149,0,9,0,0,0,9
E02004150,1,0,0,0,0,1
E02004151,1,0,0,0,0,1
E02004152,1,1,0,0,0,2
E02004153,1,0,0,0,0,1
E02004154,0,0,0,0,0,0
E02004155,0,1,0,0,0,1
E02004156,0,1,0,0,0,1
E02004157,1,0,0,0,0,1
E02004158,0,1,0,0,0,1
E02004159,0,2,0,0,0,2
E02004160,1,10,1,1,0,13
E02004161,0,1,0,0,0,1
E02004162,1,3,0,0,0,4
E02004163,0,1,0,0,0,1
E02004164,0,0,1,0,0,1
E02004165,0,1,2,0,0,3
E02004166,0,2,0,0,0,2
E02004167,0,1,0,0,0,1
E02004168,0,2,0,0,0,2
E02004169,0,2,0,1,0,3
E02004170,0,2,0,0,0,2
E02004171,0,0,0,0,0,0
E02004172,0,2,0,0,0,2
E02004173,0,0,1,0,0,1
E02004174,0,0,0,0,1,1
E02004175,0,0,0,0,0,0
E02004176,0,0,0,0,0,0
E02004177,0,2,1,0,0,3
E02004178,0,0,0,0,0,0
E02004179,0,2,0,0,0,2
E02004180,0,3,0,0,0,3
E02004181,0,6,0,0,0,6
E02004182,0,1,0,0,0,1
E02004183,0,0,0,0,0,0
E02004184,0,1,0,0,0,1
E02004185,0,0,0,0,0,0
E02004186,0,1,0,0,0,1
E02004187,0,5,1,0,0,6
E02004188,0,3,0,0,0,3
E02004189,0,1,0,0,0,1
E02004190,0,0,0,0,0,0
E02004191,0,1,0,0,0,1
E02004192,0,2,0,0,0,2
E02004193,2,1,1,0,0,4
E02004194,0,0,0,0,0,0
E02004195,0,0,0,0,0,0
E02004196,0,0,0,0,0,0
E02004197,0,1,0,0,0,1
E02004198,0,1,0,0,0,1
E02004199,0,0,2,0,0,2
E02004200,0,0,0,0,0,0
E02004201,0,0,0,0,0,0
E02004202,1,1,0,0,0,2
E02004203,0,0,5,0,0,5
E02004204,2,3,0,0,0,5
E02004205,0,2,0,0,0,2
E02004206,1,1,0,0,0,2
E02004207,0,0,0,0,0,0
E02004208,0,0,0,0,0,0
E02004209,0,2,0,0,0,2
E02004210,0,1,0,0,0,1
E02004211,0,5,0,0,0,5
E02004212,0,0,0,0,0,0
E02004213,0,0,0,0,0,0
E02004214,0,0,0,0,0,0
E02004215,1,2,0,0,0,3
E02004216,0,2,0,0,0,2
E02004217,1,0,0,0,0,1
E02004218,0,0,1,1,0,2
E02004219,0,1,0,0,0,1
E02004220,0,1,0,0,0,1
E02004221,0,0,0,0,0,0
E02004222,0,1,0,0,0,1
E02004223,0,2,2,0,0,4
E02004224,0,0,0,0,0,0
E02004225,0,0,0,0,0,0
E02004226,0,0,0,0,0,0
E02004227,0,10,1,0,0,11
E02004228,0,2,1,0,0,3
E02004229,0,1,0,0,0,1
E02004230,0,2,1,0,0,3
E02004231,1,0,1,0,0,2
E02004232,0,2,0,0,0,2
E02004233,0,4,1,0,0,5
E02004234,0,2,0,1,1,4
E02004235,0,0,0,0,0,0
E02004236,0,0,0,0,0,0
E02004237,0,3,1,3,0,7
E02004238,0,0,1,0,0,1
E02004239,1,2,1,0,0,4
E02004240,0,3,2,0,0,5
E02004241,0,4,0,0,0,4
E02004242,0,3,0,1,0,4
E02004243,0,1,1,0,0,2
E02004244,1,0,1,0,0,2
E02004245,0,3,0,0,0,3
E02004246,0,2,2,1,0,5
E02004247,0,0,0,0,0,0
E02004248,0,2,0,0,0,2
E02004249,0,2,0,0,0,2
E02004250,0,2,1,0,0,3
E02004251,1,1,2,1,0,5
E02004252,0,2,7,0,0,9
E02004253,1,4,1,0,0,6
E02004254,0,1,0,0,0,1
E02004255,1,2,1,1,0,5
E02004256,0,0,1,0,0,1
E02004257,0,4,0,0,0,4
E02004258,0,2,1,0,0,3
E02004259,0,2,0,0,0,2
E02004260,0,0,0,0,1,1
E02004261,0,4,2,0,0,6
E02004262,0,0,0,0,0,0
E02004263,0,1,2,0,0,3
E02004264,0,0,1,0,0,1
E02004265,0,3,1,0,0,4
E02004266,0,0,1,0,0,1
E02004267,0,2,1,0,0,3
E02004268,0,0,0,0,0,0
E02004269,0,2,1,0,0,3
E02004270,1,1,0,0,0,2
E02004271,0,1,1,0,0,2
E02004272,0,13,1,0,0,14
E02004273,0,0,0,0,0,0
E02004274,1,2,0,0,0,3
E02004275,0,1,0,0,0,1
E02004276,0,1,0,0,0,1
E02004277,0,20,3,0,0,23
E02004278,1,0,0,0,0,1
E02004279,0,1,1,0,0,2
E02004280,1,1,0,0,0,2
E02004281,1,0,0,0,0,1
E02004282,0,8,1,0,0,9
E02004283,0,8,0,1,0,9
E02004284,0,3,0,0,0,3
E02004285,0,1,0,0,0,1
E02004286,0,6,2,0,0,8
E02004287,0,0,0,0,0,0
E02004288,0,1,1,0,0,2
E02004289,1,0,0,0,0,1
E02004290,1,9,0,0,0,10
E02004291,0,11,3,3,1,18
E02004292,0,5,4,1,0,10
E02004293,1,6,3,0,0,10
E02004294,1,3,1,0,0,5
E02004295,1,1,1,1,0,4
E02004296,2,2,1,0,0,5
E02004297,1,4,5,0,0,10
E02004298,1,2,8,1,0,12
E02004299,0,15,6,1,0,22
E02004300,0,5,2,0,0,7
E02004301,2,25,4,0,0,31
E02004302,0,3,7,1,0,11
E02004303,0,10,3,0,0,13
E02004304,0,9,18,3,1,31
E02004305,0,6,4,0,0,10
E02004306,1,3,1,1,0,6
E02004307,0,8,1,0,0,9
E02004308,1,10,1,0,0,12
E02004309,0,8,4,1,0,13
E02004310,0,2,4,0,0,6
E02004311,0,10,2,1,0,13
E02004312,1,4,2,0,0,7
E02004313,0,0,0,0,1,1
E02004314,0,7,9,0,0,16
E02004315,1,3,17,1,0,22
E02004316,1,2,4,1,0,8
E02004317,1,9,4,2,0,16
E02004318,1,8,1,0,0,10
E02004319,0,1,1,0,0,2
E02004320,0,7,5,4,0,16
E02004321,0,20,2,0,0,22
E02004322,0,20,4,1,0,25
E02004323,0,8,2,0,0,10
E02004324,1,6,0,0,0,7
E02004325,1,14,2,0,0,17
E02004326,0,6,2,1,0,9
E02004327,1,6,1,0,0,8
E02004328,1,3,0,1,0,5
E02004329,0,4,5,0,0,9
E02004330,0,7,12,2,0,21
E02004331,1,13,0,0,0,14
E02004332,1,5,2,1,0,9
E02004333,0,1,2,0,0,3
E02004334,0,1,1,1,0,3
E02004335,0,1,1,1,0,3
E02004336,1,1,1,0,0,3
E02004337,1,2,1,0,0,4
E02004338,1,1,8,0,0,10
E02004339,0,0,1,1,1,3
E02004340,0,4,15,3,0,22
E02004341,0,7,2,0,0,9
E02004342,3,4,2,3,0,12
E02004343,0,4,3,1,1,9
E02004344,0,4,1,1,0,6
E02004345,1,4,3,3,0,11
E02004346,0,2,1,0,0,3
E02004347,0,4,3,7,0,14
E02004348,0,3,1,0,0,4
E02004349,1,1,0,1,0,3
E02004350,0,7,2,0,0,9
E02004351,0,4,1,1,0,6
E02004352,0,4,1,0,0,5
E02004353,0,6,19,13,0,38
E02004354,0,0,0,0,0,0
E02004355,0,4,1,0,0,5
E02004356,0,2,0,0,0,2
E02004357,1,0,2,0,0,3
E02004358,0,1,1,2,1,5
E02004359,2,2,3,0,0,7
E02004361,1,6,0,0,0,7
E02004362,0,2,3,0,1,6
E02004363,0,1,4,0,0,5
E02004364,2,3,2,0,0,7
E02004365,0,0,0,0,0,0
E02004366,0,3,3,0,0,6
E02004367,0,5,6,2,0,13
E02004368,1,0,0,0,0,1
E02004369,0,0,0,0,0,0
E02004370,0,1,0,1,0,2
E02004371,0,0,0,0,0,0
E02004372,0,0,0,0,0,0
E02004373,0,2,0,0,0,2
E02004374,0,1,0,0,0,1
E02004375,0,1,1,0,0,2
E02004376,0,0,0,0,0,0
E02004377,0,0,1,0,0,1
E02004378,0,1,0,0,0,1
E02004379,0,2,1,0,0,3
E02004380,0,10,5,1,1,17
E02004381,0,1,2,1,0,4
E02004382,2,9,7,0,0,18
E02004383,0,2,0,1,0,3
E02004384,0,8,1,1,0,10
E02004385,2,5,0,2,0,9
E02004386,1,2,1,1,0,5
E02004387,1,1,2,0,0,4
E02004388,0,2,1,1,0,4
E02004389,2,12,9,1,1,25
E02004390,0,3,4,0,1,8
E02004391,0,5,1,0,0,6
E02004392,0,2,1,1,0,4
E02004393,0,1,1,0,0,2
E02004394,0,0,7,0,0,7
E02004395,0,0,0,0,1,1
E02004396,0,3,0,0,0,3
E02004397,0,1,0,0,0,1
E02004398,1,2,0,1,0,4
E02004399,1,3,6,0,1,11
E02004400,1,7,4,2,0,14
E02004401,0,0,1,0,0,1
E02004402,0,1,6,1,1,9
E02004403,0,4,2,2,0,8
E02004404,0,0,0,0,0,0
E02004405,0,1,0,0,0,1
E02004406,2,6,4,1,1,14
E02004407,0,2,13,0,0,15
E02004408,0,1,0,1,0,2
E02004409,0,3,1,0,0,4
E02004410,0,2,1,3,0,6
E02004411,1,6,0,0,0,7
E02004412,0,1,1,0,0,2
E02004413,0,7,2,0,0,9
E02004414,1,7,1,0,0,9
E02004415,2,0,0,1,0,3
E02004416,0,1,0,0,1,2
E02004417,0,2,0,0,0,2
E02004418,0,2,1,0,2,5
E02004419,0,3,3,2,1,9
E02004420,0,3,4,0,1,8
E02004421,0,5,1,0,2,8
E02004422,0,2,1,0,0,3
E02004423,0,2,1,0,0,3
E02004424,1,1,1,0,0,3
E02004425,1,6,3,0,1,11
E02004426,1,9,1,2,0,13
E02004427,2,4,1,1,0,8
E02004428,0,7,4,1,0,12
E02004429,1,6,1,2,0,10
E02004430,0,2,0,1,0,3
E02004431,1,4,1,0,0,6
E02004432,1,2,2,0,0,5
E02004433,0,3,2,1,0,6
E02004434,2,10,3,0,1,16
E02004435,0,7,2,2,0,11
E02004436,0,6,2,0,1,9
E02004437,1,13,4,2,0,20
E02004438,1,13,3,3,0,20
E02004439,0,3,2,1,0,6
E02004440,0,4,2,1,0,7
E02004441,2,4,1,0,2,9
E02004442,0,4,4,0,0,8
E02004443,1,5,3,0,0,9
E02004444,2,8,0,0,1,11
E02004445,1,6,2,0,1,10
E02004446,0,1,1,0,0,2
E02004447,0,1,0,0,0,1
E02004448,0,3,1,1,0,5
E02004449,0,7,1,0,0,8
E02004450,1,4,0,0,0,5
E02004451,0,7,6,3,0,16
E02004452,0,12,1,1,0,14
E02004453,1,4,0,0,0,5
E02004454,0,3,4,0,3,10
E02004455,1,3,1,0,0,5
E02004456,0,4,0,1,0,5
E02004457,1,1,2,0,0,4
E02004458,0,6,1,0,0,7
E02004459,1,4,3,0,0,8
E02004460,2,2,1,0,0,5
E02004461,0,0,0,0,0,0
E02004462,1,3,0,1,1,6
E02004463,0,8,7,0,0,15
E02004464,0,7,6,1,1,15
E02004465,1,2,4,2,1,10
E02004466,0,6,0,0,0,6
E02004467,0,4,2,0,0,6
E02004468,0,9,2,3,0,14
E02004469,2,2,1,0,0,5
E02004470,4,6,2,0,0,12
E02004471,2,13,1,1,0,17
E02004472,0,4,0,0,0,4
E02004473,0,6,3,0,1,10
E02004474,0,1,0,2,0,3
E02004475,0,1,0,2,0,3
E02004476,0,2,7,3,0,12
E02004477,1,3,1,0,0,5
E02004478,2,3,0,3,1,9
E02004479,1,4,5,2,1,13
E02004480,1,5,1,1,0,8
E02004481,0,8,1,2,3,14
E02004482,0,3,1,0,0,4
E02004483,0,5,1,2,0,8
E02004484,3,5,0,2,0,10
E02004485,2,3,2,0,0,7
E02004486,0,6,1,0,0,7
E02004487,0,1,1,0,0,2
E02004488,0,3,4,3,0,10
E02004489,0,0,2,0,0,2
E02004490,1,6,2,0,0,9
E02004491,1,2,0,0,0,3
E02004492,0,5,1,0,0,6
E02004493,3,6,3,0,0,12
E02004494,2,8,9,0,0,19
E02004495,2,3,2,1,0,8
E02004496,1,4,2,1,0,8
E02004497,0,9,0,0,0,9
E02004498,1,5,2,0,0,8
E02004499,1,2,0,0,0,3
E02004500,0,1,0,0,0,1
E02004501,1,0,1,0,0,2
E02004502,1,2,1,1,1,6
E02004503,0,6,0,0,0,6
E02004504,1,5,4,4,2,16
E02004505,0,6,0,1,1,8
E02004506,0,11,5,0,1,17
E02004507,0,1,0,0,0,1
E02004508,0,3,0,0,0,3
E02004509,0,2,1,0,0,3
E02004512,0,2,0,0,0,2
E02004513,0,2,0,0,0,2
E02004514,0,2,0,0,0,2
E02004515,0,2,0,0,0,2
E02004516,0,2,1,0,0,3
E02004517,1,8,6,1,0,16
E02004518,0,0,1,0,0,1
E02004519,0,4,0,0,0,4
E02004520,0,3,0,0,0,3
E02004521,0,4,2,1,0,7
E02004522,0,4,1,0,0,5
E02004523,0,0,2,0,0,2
E02004524,0,3,7,0,0,10
E02004525,0,4,3,1,0,8
E02004526,1,2,3,0,0,6
E02004527,2,7,1,0,0,10
E02004528,0,5,0,0,0,5
E02004529,1,2,2,0,0,5
E02004530,1,4,1,2,0,8
E02004531,0,6,3,0,0,9
E02004532,2,5,0,0,0,7
E02004533,0,18,2,0,0,20
E02004534,1,2,0,0,0,3
E02004535,2,17,1,0,0,20
E02004536,1,12,0,1,0,14
E02004537,0,7,3,2,0,12
E02004538,0,13,0,0,0,13
E02004539,1,3,2,0,0,6
E02004540,4,3,1,0,0,8
E02004541,0,19,0,1,0,20
E02004542,1,4,0,0,0,5
E02004543,0,16,3,0,0,19
E02004544,1,7,0,0,0,8
E02004545,1,4,0,0,0,5
E02004546,1,4,0,1,0,6
E02004547,1,3,0,0,0,4
E02004548,0,2,0,1,0,3
E02004549,0,8,0,0,0,8
E02004550,3,8,0,1,1,13
E02004551,0,7,2,0,0,9
E02004552,0,5,2,0,0,7
E02004553,1,4,1,0,0,6
E02004554,0,4,2,0,0,6
E02004555,0,2,0,0,0,2
E02004556,1,3,0,0,0,4
E02004557,0,4,4,1,1,10
E02004558,2,2,1,0,0,5
E02004559,1,0,0,0,0,1
E02004560,0,5,0,0,0,5
E02004561,1,3,1,0,0,5
E02004562,0,3,0,0,0,3
E02004563,0,4,0,1,0,5
E02004564,0,6,3,0,2,11
E02004565,2,4,3,1,0,10
E02004566,1,2,1,0,0,4
E02004567,0,7,4,1,0,12
E02004568,1,4,2,2,0,9
E02004569,1,8,3,0,2,14
E02004570,3,3,3,4,2,15
E02004571,0,3,3,0,0,6
E02004572,2,3,3,0,0,8
E02004573,0,5,3,1,0,9
E02004574,1,2,1,0,0,4
E02004575,1,6,2,0,0,9
E02004576,0,4,3,0,0,7
E02004577,1,1,1,1,0,4
E02004578,0,15,8,2,0,25
E02004579,0,4,0,1,0,5
E02004580,1,13,2,3,0,19
E02004581,2,1,6,5,1,15
E02004582,3,7,2,0,0,12
E02004583,0,3,0,3,0,6
E02004584,3,6,3,1,0,13
E02004585,1,2,1,0,0,4
E02004586,2,3,4,1,0,10
E02004587,0,3,2,0,0,5
E02004588,0,5,4,0,0,9
E02004589,1,1,1,1,0,4
E02004590,0,8,2,0,1,11
E02004591,0,1,1,0,0,2
E02004592,0,0,1,0,0,1
E02004593,0,1,1,0,0,2
E02004594,0,3,0,0,0,3
E02004595,1,13,6,0,0,20
E02004596,0,4,0,0,0,4
E02004597,3,9,5,1,0,18
E02004598,0,1,7,0,0,8
E02004599,2,2,0,0,0,4
E02004600,0,3,0,0,0,3
E02004601,0,3,3,0,0,6
E02004602,0,8,2,0,0,10
E02004603,0,0,1,0,0,1
E02004604,0,7,1,0,0,8
E02004605,0,1,1,0,0,2
E02004606,1,26,5,0,1,33
E02004607,1,14,1,1,0,17
E02004608,1,4,2,0,0,7
E02004609,0,3,2,0,0,5
E02004610,1,4,0,0,0,5
E02004611,0,10,5,0,0,15
E02004612,1,5,1,0,0,7
E02004613,1,1,0,0,0,2
E02004614,0,13,1,0,0,14
E02004615,0,5,0,0,0,5
E02004616,0,4,0,0,0,4
E02004617,1,1,1,1,0,4
E02004618,1,2,0,0,0,3
E02004619,1,0,0,0,0,1
E02004620,0,4,3,0,0,7
E02004621,1,15,2,0,0,18
E02004622,0,5,0,0,0,5
E02004623,0,2,3,0,0,5
E02004624,0,3,1,0,0,4
E02004625,0,2,0,0,0,2
E02004626,1,0,1,0,0,2
E02004627,1,1,0,0,0,2
E02004628,1,2,4,1,0,8
E02004629,1,3,0,1,0,5
E02004630,0,4,0,1,0,5
E02004631,0,1,1,0,0,2
E02004632,1,4,2,0,0,7
E02004633,1,7,0,0,0,8
E02004634,0,5,1,0,0,6
E02004635,0,3,0,0,0,3
E02004636,0,4,1,0,0,5
E02004637,3,11,9,0,1,24
E02004638,1,8,1,0,0,10
E02004639,1,7,0,0,0,8
E02004640,0,1,0,0,0,1
E02004641,0,6,0,0,0,6
E02004642,1,6,3,0,0,10
E02004643,0,6,1,0,0,7
E02004644,1,5,1,0,0,7
E02004645,0,0,0,0,0,0
E02004646,1,11,5,0,0,17
E02004647,0,16,14,0,0,30
E02004648,0,3,1,0,0,4
E02004649,0,3,0,0,0,3
E02004650,0,10,3,0,0,13
E02004651,1,8,2,0,0,11
E02004652,1,3,0,0,0,4
E02004653,0,5,0,0,0,5
E02004654,0,9,2,0,0,11
E02004655,0,7,4,1,0,12
E02004656,0,4,0,0,0,4
E02004657,0,4,0,0,0,4
E02004658,0,2,1,1,0,4
E02004659,0,3,2,0,0,5
E02004660,1,0,0,0,0,1
E02004661,0,3,1,0,0,4
E02004662,0,5,4,0,0,9
E02004663,2,7,1,0,0,10
E02004664,0,4,0,0,0,4
E02004665,1,2,1,0,0,4
E02004666,0,12,4,0,0,16
E02004667,0,4,2,0,0,6
E02004668,0,5,0,0,0,5
E02004669,1,4,1,0,0,6
E02004670,1,18,1,0,0,20
E02004671,0,2,0,0,0,2
E02004672,0,12,0,0,0,12
E02004673,1,5,1,0,0,7
E02004674,0,25,3,2,0,30
E02004675,0,2,0,0,0,2
E02004676,1,4,1,0,0,6
E02004677,0,1,0,0,0,1
E02004678,1,7,0,0,0,8
E02004679,1,3,1,2,0,7
E02004680,0,2,0,0,0,2
E02004681,0,6,0,1,0,7
E02004682,0,2,0,0,0,2
E02004683,2,6,2,1,0,11
E02004684,2,6,1,0,0,9
E02004685,0,3,1,0,0,4
E02004686,0,3,0,0,0,3
E02004687,1,0,2,0,0,3
E02004688,0,4,1,1,0,6
E02004689,0,2,1,1,0,4
E02004690,0,1,0,0,0,1
E02004691,0,9,4,1,0,14
E02004692,0,2,1,0,0,3
E02004693,2,5,1,0,0,8
E02004694,0,5,6,0,0,11
E02004695,0,0,0,0,0,0
E02004696,1,3,1,0,0,5
E02004697,0,2,0,0,0,2
E02004698,0,6,1,0,0,7
E02004699,0,9,9,1,0,19
E02004700,0,3,0,0,0,3
E02004702,0,2,3,0,0,5
E02004703,1,2,2,0,0,5
E02004704,1,2,0,0,0,3
E02004705,2,5,1,1,0,9
E02004706,2,1,1,0,0,4
E02004707,0,8,3,0,0,11
E02004708,0,1,0,0,0,1
E02004709,1,1,0,0,0,2
E02004710,1,0,0,0,0,1
E02004712,2,6,3,1,0,12
E02004713,0,1,5,0,0,6
E02004714,2,8,1,0,0,11
E02004715,0,2,0,0,0,2
E02004716,0,3,3,0,0,6
E02004717,0,10,2,0,0,12
E02004718,0,2,0,0,0,2
E02004719,0,5,1,0,0,6
E02004720,0,6,8,0,0,14
E02004721,0,1,0,1,0,2
E02004722,1,3,1,1,0,6
E02004723,0,0,2,1,0,3
E02004724,1,3,1,0,0,5
E02004725,0,5,2,1,0,8
E02004726,1,2,1,0,0,4
E02004727,0,6,0,0,0,6
E02004728,1,7,2,1,0,11
E02004729,2,2,1,1,0,6
E02004730,1,2,2,0,0,5
E02004731,3,1,1,1,0,6
E02004732,1,2,1,0,0,4
E02004733,0,1,0,0,0,1
E02004734,3,5,1,0,0,9
E02004735,3,8,0,0,0,11
E02004736,1,2,1,0,0,4
E02004737,1,2,1,0,0,4
E02004738,1,7,2,0,0,10
E02004739,1,8,6,0,0,15
E02004740,1,4,1,0,0,6
E02004741,3,0,0,0,0,3
E02004742,0,2,1,0,0,3
E02004743,1,1,0,0,0,2
E02004744,0,0,1,0,0,1
E02004745,0,2,0,0,1,3
E02004746,1,6,0,0,0,7
E02004747,1,1,0,0,0,2
E02004748,1,4,3,0,0,8
E02004749,1,13,0,0,0,14
E02004750,1,10,3,0,0,14
E02004751,1,9,1,0,1,12
E02004752,0,4,0,0,0,4
E02004753,0,5,1,0,0,6
E02004754,1,1,0,1,0,3
E02004755,0,0,0,0,0,0
E02004756,0,2,0,0,0,2
E02004757,1,4,1,0,0,6
E02004758,0,6,0,0,0,6
E02004759,0,1,0,1,0,2
E02004760,0,2,2,1,0,5
E02004761,1,2,0,0,0,3
E02004764,0,2,5,0,1,8
E02004765,0,3,0,0,0,3
E02004766,0,8,3,1,0,12
E02004767,1,2,0,0,1,4
E02004768,1,1,2,0,0,4
E02004769,1,1,1,0,0,3
E02004770,2,4,1,0,0,7
E02004771,0,3,2,0,0,5
E02004772,1,2,1,1,0,5
E02004774,1,7,1,0,0,9
E02004775,3,5,2,0,0,10
E02004776,0,3,2,0,0,5
E02004777,0,11,3,1,1,16
E02004778,0,3,0,0,0,3
E02004779,0,3,0,1,0,4
E02004780,0,5,1,1,0,7
E02004781,0,1,1,0,0,2
E02004782,0,3,0,0,0,3
E02004783,0,3,0,0,0,3
E02004784,1,17,6,0,0,24
E02004785,0,2,1,1,0,4
E02004786,0,0,1,0,0,1
E02004787,0,8,3,0,0,11
E02004788,0,1,1,0,0,2
E02004789,1,5,0,0,0,6
E02004790,0,4,0,0,0,4
E02004791,0,3,1,0,0,4
E02004792,0,1,4,0,0,5
E02004793,0,6,1,0,0,7
E02004794,0,4,4,0,0,8
E02004795,1,2,0,0,1,4
E02004796,0,4,0,0,0,4
E02004797,0,2,0,0,0,2
E02004798,0,2,0,0,0,2
E02004799,0,3,2,1,0,6
E02004800,1,6,9,1,0,17
E02004801,0,1,0,0,0,1
E02004802,1,1,1,1,0,4
E02004803,0,1,1,2,0,4
E02004804,1,3,1,0,0,5
E02004805,0,7,1,0,0,8
E02004806,0,1,0,0,0,1
E02004807,0,2,2,0,0,4
E02004808,0,13,0,0,1,14
E02004809,0,3,2,0,0,5
E02004810,2,5,0,0,0,7
E02004811,0,3,0,0,0,3
E02004812,0,6,3,2,0,11
E02004813,0,16,2,1,0,19
E02004814,0,2,1,1,0,4
E02004815,0,1,1,0,0,2
E02004816,0,15,3,0,0,18
E02004817,0,8,4,0,0,12
E02004818,0,3,0,1,0,4
E02004819,1,4,3,0,0,8
E02004820,0,7,0,0,2,9
E02004821,0,4,2,0,0,6
E02004822,0,4,2,1,0,7
E02004823,1,5,2,0,0,8
E02004824,1,6,3,1,1,12
E02004825,1,7,11,1,1,21
E02004826,0,2,1,2,0,5
E02004827,0,0,0,0,0,0
E02004828,0,1,2,0,0,3
E02004829,0,1,0,1,0,2
E02004830,0,2,1,0,0,3
E02004831,2,10,2,0,1,15
E02004832,0,1,3,0,0,4
E02004833,1,12,6,0,0,19
E02004834,1,2,5,0,0,8
E02004835,0,9,1,0,0,10
E02004836,0,1,0,0,0,1
E02004837,0,6,0,0,0,6
E02004838,0,0,3,0,0,3
E02004839,0,2,1,0,0,3
E02004840,2,4,1,0,1,8
E02004841,1,5,3,1,0,10
E02004842,0,4,14,1,0,19
E02004843,1,8,0,0,0,9
E02004844,2,1,0,0,0,3
E02004845,1,4,1,0,0,6
E02004846,1,5,0,0,1,7
E02004847,2,4,1,0,0,7
E02004848,0,3,3,0,0,6
E02004849,2,0,0,0,0,2
E02004850,2,2,1,0,0,5
E02004851,3,4,1,0,0,8
E02004852,2,3,1,0,0,6
E02004853,0,3,2,0,0,5
E02004854,1,6,1,0,0,8
E02004855,0,3,0,0,0,3
E02004856,1,0,2,0,0,3
E02004857,0,1,0,0,1,2
E02004858,1,1,0,0,0,2
E02004859,0,3,2,0,0,5
E02004860,0,2,0,0,0,2
E02004861,1,4,1,0,0,6
E02004862,0,3,0,0,0,3
E02004863,3,12,2,0,0,17
E02004864,0,0,0,1,0,1
E02004865,0,2,0,0,0,2
E02004866,0,2,2,0,0,4
E02004867,2,1,0,1,1,5
E02004868,1,12,2,1,0,16
E02004869,0,2,0,0,0,2
E02004870,0,8,1,0,0,9
E02004871,0,3,0,0,0,3
E02004872,2,3,2,1,0,8
E02004873,1,5,3,0,0,9
E02004874,0,8,1,0,0,9
E02004875,0,4,1,1,0,6
E02004876,1,7,0,1,0,9
E02004877,0,1,0,0,0,1
E02004878,0,0,0,0,0,0
E02004879,0,0,3,0,0,3
E02004880,1,11,1,0,0,13
E02004881,1,1,1,0,0,3
E02004882,0,4,2,0,0,6
E02004883,1,3,1,0,0,5
E02004884,0,1,0,1,0,2
E02004885,0,0,0,0,0,0
E02004886,0,1,0,0,0,1
E02004887,2,1,1,0,0,4
E02004888,3,3,1,0,0,7
E02004889,0,21,2,1,0,24
E02004890,0,3,0,0,0,3
E02004891,0,3,0,0,0,3
E02004892,1,2,0,0,0,3
E02004893,0,3,0,0,0,3
E02004894,0,5,0,1,1,7
E02004895,0,11,3,0,0,14
E02004896,1,26,3,0,0,30
E02004897,0,7,1,0,0,8
E02004898,0,8,0,0,0,8
E02004899,1,4,2,0,0,7
E02004900,2,8,2,0,0,12
E02004901,6,14,4,0,0,24
E02004902,0,7,2,1,0,10
E02004903,1,2,1,1,0,5
E02004904,1,10,0,0,0,11
E02004905,2,9,4,0,0,15
E02004906,2,6,0,0,0,8
E02004907,1,11,2,1,0,15
E02004908,8,15,3,0,1,27
E02004909,1,0,0,0,0,1
E02004910,0,3,1,0,0,4
E02004911,0,6,0,0,0,6
E02004912,1,7,12,1,0,21
E02004913,1,8,1,0,0,10
E02004914,0,0,0,1,0,1
E02004915,0,1,1,0,0,2
E02004916,0,0,3,0,0,3
E02004917,0,7,3,0,1,11
E02004918,0,1,2,1,0,4
E02004919,0,2,1,0,0,3
E02004920,0,6,5,1,1,13
E02004921,0,1,1,0,0,2
E02004922,0,0,1,0,0,1
E02004923,1,13,2,0,0,16
E02004924,0,5,0,3,0,8
E02004925,0,0,2,0,1,3
E02004926,0,3,1,1,1,6
E02004927,0,1,1,0,0,2
E02004928,1,0,2,1,2,6
E02004929,0,3,0,0,0,3
E02004930,0,4,1,0,0,5
E02004931,0,5,0,0,0,5
E02004932,0,1,2,0,2,5
E02004933,0,4,0,0,0,4
E02004934,0,8,2,0,0,10
E02004935,2,3,0,0,0,5
E02004936,0,4,0,0,0,4
E02004937,0,10,1,0,2,13
E02004938,0,5,3,1,1,10
E02004939,1,7,0,0,0,8
E02004940,1,9,1,0,0,11
E02004941,1,8,1,0,0,10
E02004942,0,3,0,1,0,4
E02004943,1,9,2,0,0,12
E02004944,0,2,0,1,0,3
E02004945,0,19,3,0,0,22
E02004946,0,2,2,0,0,4
E02004947,0,1,1,0,0,2
E02004948,0,2,1,0,0,3
E02004949,1,5,2,1,1,10
E02004950,0,1,2,0,0,3
E02004951,1,3,0,0,0,4
E02004952,0,1,1,0,0,2
E02004953,0,1,1,0,0,2
E02004954,0,2,2,0,0,4
E02004955,0,1,0,0,0,1
E02004956,1,3,2,0,0,6
E02004957,0,4,3,1,0,8
E02004958,0,2,1,0,0,3
E02004959,1,7,1,0,0,9
E02004960,1,3,1,0,0,5
E02004961,2,3,1,0,0,6
E02004962,0,5,1,0,0,6
E02004963,0,1,0,0,1,2
E02004964,2,4,1,0,0,7
E02004965,1,7,1,0,0,9
E02004966,0,16,5,0,0,21
E02004967,0,5,1,0,0,6
E02004968,1,9,1,0,0,11
E02004969,0,5,2,1,0,8
E02004970,1,2,0,0,0,3
E02004971,1,3,2,1,1,8
E02004972,0,2,0,0,0,2
E02004973,0,4,1,0,0,5
E02004974,7,23,3,1,0,34
E02004975,0,5,2,1,0,8
E02004976,0,6,1,0,0,7
E02004977,0,5,1,1,0,7
E02004978,0,19,4,1,3,27
E02004979,0,2,2,0,1,5
E02004980,0,9,2,0,0,11
E02004981,1,3,2,0,1,7
E02004982,1,1,1,1,0,4
E02004983,2,2,2,1,0,7
E02004984,3,5,6,0,0,14
E02004985,1,4,1,0,0,6
E02004986,0,0,0,1,0,1
E02004987,0,2,2,0,0,4
E02004988,0,1,0,0,0,1
E02004989,1,6,7,2,1,17
E02004990,0,4,5,0,0,9
E02004991,2,4,2,0,0,8
E02004992,1,6,2,0,0,9
E02004993,1,1,2,0,0,4
E02004994,1,4,0,0,0,5
E02004995,0,5,0,1,0,6
E02004996,0,2,5,4,1,12
E02004997,0,2,2,4,2,10
E02004998,0,1,3,0,1,5
E02004999,1,15,6,5,4,31
E02005000,1,6,4,4,3,18
E02005001,0,2,3,5,1,11
E02005002,0,3,3,7,2,15
E02005003,0,2,0,0,1,3
E02005004,0,9,10,1,1,21
E02005005,0,2,0,4,0,6
E02005006,0,0,2,0,0,2
E02005007,0,5,4,3,4,16
E02005008,1,2,2,8,1,14
E02005009,0,2,3,2,0,7
E02005010,0,4,2,0,0,6
E02005011,1,9,3,0,1,14
E02005012,0,4,1,1,1,7
E02005013,0,6,1,1,0,8
E02005014,1,5,4,1,0,11
E02005015,1,4,2,2,1,10
E02005016,0,4,1,1,0,6
E02005017,0,0,1,0,0,1
E02005018,0,10,3,3,2,18
E02005019,0,1,1,1,0,3
E02005020,0,5,2,0,0,7
E02005021,1,3,2,0,0,6
E02005022,0,1,0,1,0,2
E02005023,0,2,0,0,2,4
E02005025,0,2,2,3,1,8
E02005026,0,3,3,2,0,8
E02005027,0,1,0,1,1,3
E02005028,1,7,2,3,4,17
E02005029,1,7,0,0,0,8
E02005030,0,4,1,0,0,5
E02005031,1,1,0,1,0,3
E02005032,0,2,0,0,0,2
E02005033,2,9,3,1,1,16
E02005034,0,3,0,0,1,4
E02005035,3,12,5,0,2,22
E02005036,1,6,1,0,0,8
E02005037,0,7,2,2,2,13
E02005038,0,3,0,2,0,5
E02005039,1,5,2,0,0,8
E02005040,0,10,2,2,0,14
E02005041,1,1,2,1,0,5
E02005042,0,3,2,1,2,8
E02005043,0,3,3,0,0,6
E02005044,1,4,0,1,1,7
E02005045,0,6,1,2,2,11
E02005046,0,3,1,3,0,7
E02005047,0,2,1,1,0,4
E02005048,0,5,5,2,1,13
E02005049,1,1,3,1,0,6
E02005050,1,7,8,10,3,29
E02005051,0,3,3,3,1,10
E02005052,0,4,3,2,0,9
E02005053,0,6,4,0,0,10
E02005054,0,3,2,3,0,8
E02005055,0,5,0,0,0,5
E02005056,1,6,3,1,0,11
E02005057,0,5,1,1,1,8
E02005058,0,5,0,1,2,8
E02005059,0,3,0,1,2,6
E02005060,1,9,4,1,2,17
E02005061,2,9,3,0,1,15
E02005062,1,2,0,2,1,6
E02005063,1,1,2,1,0,5
E02005064,0,2,0,0,0,2
E02005065,0,6,2,0,2,10
E02005066,0,3,1,0,2,6
E02005067,0,3,0,0,0,3
E02005068,1,0,1,0,0,2
E02005069,0,13,2,1,0,16
E02005070,0,4,2,0,0,6
E02005071,0,1,1,0,0,2
E02005072,1,0,1,0,0,2
E02005073,1,7,8,0,0,16
E02005074,1,2,1,0,0,4
E02005075,0,7,2,2,0,11
E02005076,1,7,1,0,0,9
E02005077,1,0,0,0,0,1
E02005078,1,4,3,0,0,8
E02005079,0,7,0,0,0,7
E02005080,0,4,2,1,0,7
E02005081,0,2,0,0,0,2
E02005082,0,1,1,1,0,3
E02005083,1,4,0,1,0,6
E02005084,1,4,1,1,0,7
E02005085,0,1,1,0,0,2
E02005086,0,1,2,1,0,4
E02005087,3,9,1,0,1,14
E02005088,0,6,1,1,0,8
E02005089,0,4,1,1,0,6
E02005090,0,9,0,0,1,10
E02005091,0,8,1,1,2,12
E02005093,1,8,0,2,1,12
E02005094,0,2,0,0,0,2
E02005095,1,1,0,0,0,2
E02005096,0,2,2,0,0,4
E02005097,1,3,3,1,0,8
E02005098,0,13,4,1,0,18
E02005099,0,2,0,0,0,2
E02005100,1,0,1,1,0,3
E02005101,1,1,0,0,0,2
E02005102,0,6,1,1,0,8
E02005103,1,4,6,1,0,12
E02005104,0,3,3,1,2,9
E02005105,0,2,1,2,2,7
E02005106,0,5,2,1,1,9
E02005107,0,6,10,7,3,26
E02005109,0,1,3,4,2,10
E02005110,0,4,1,1,0,6
E02005111,0,6,3,2,0,11
E02005112,0,3,4,2,0,9
E02005113,0,2,6,4,1,13
E02005114,0,0,1,2,2,5
E02005115,0,0,3,0,0,3
E02005116,0,1,2,0,0,3
E02005117,0,4,0,1,0,5
E02005118,0,4,0,0,0,4
E02005119,1,4,1,0,0,6
E02005120,0,6,1,0,0,7
E02005121,0,4,0,1,0,5
E02005122,0,1,0,0,0,1
E02005123,1,6,1,0,0,8
E02005124,1,9,3,0,0,13
E02005125,0,8,0,0,0,8
E02005126,2,3,2,0,0,7
E02005127,0,9,1,0,0,10
E02005128,0,0,7,7,1,15
E02005129,1,10,3,1,2,17
E02005130,0,3,4,0,0,7
E02005131,0,1,2,1,0,4
E02005132,0,26,2,1,0,29
E02005133,0,11,3,1,1,16
E02005134,0,4,1,1,0,6
E02005135,0,1,4,1,0,6
E02005136,0,10,0,2,1,13
E02005137,1,2,2,0,1,6
E02005138,1,8,2,0,1,12
E02005139,0,1,0,0,2,3
E02005140,0,3,3,1,2,9
E02005141,1,6,2,0,0,9
E02005142,1,4,2,2,0,9
E02005143,0,5,2,1,1,9
E02005144,0,4,0,2,1,7
E02005145,1,4,2,0,0,7
E02005146,0,0,0,0,0,0
E02005147,0,5,4,2,3,14
E02005148,1,1,3,0,0,5
E02005149,0,3,5,0,1,9
E02005150,2,3,1,0,0,6
E02005151,2,3,4,0,0,9
E02005153,0,4,2,1,0,7
E02005154,1,0,12,0,0,13
E02005155,1,1,1,1,0,4
E02005156,0,1,1,0,0,2
E02005157,2,1,1,0,0,4
E02005158,0,4,1,0,1,6
E02005159,0,1,1,2,0,4
E02005160,1,1,1,1,0,4
E02005161,0,2,0,3,0,5
E02005162,1,1,0,4,0,6
E02005163,0,2,0,1,0,3
E02005164,0,2,1,0,1,4
E02005165,0,1,5,4,0,10
E02005166,0,1,1,0,0,2
E02005167,0,2,3,2,1,8
E02005168,0,3,1,4,1,9
E02005169,0,1,2,0,0,3
E02005170,2,4,0,0,0,6
E02005171,0,6,5,1,2,14
E02005172,0,2,0,0,0,2
E02005173,0,1,2,0,0,3
E02005174,0,5,2,0,0,7
E02005175,0,1,2,1,0,4
E02005176,1,1,0,1,0,3
E02005177,0,7,1,0,0,8
E02005178,0,3,3,0,0,6
E02005179,0,3,4,0,0,7
E02005180,0,6,0,2,1,9
E02005181,0,1,1,0,0,2
E02005182,0,4,2,0,0,6
E02005183,0,3,0,0,0,3
E02005184,0,0,1,0,0,1
E02005185,0,1,0,0,0,1
E02005186,0,0,0,1,0,1
E02005189,0,9,2,0,0,11
E02005190,0,2,0,0,0,2
E02005191,1,5,2,1,0,9
E02005192,0,5,1,1,0,7
E02005193,0,6,3,2,0,11
E02005194,0,2,2,1,0,5
E02005195,0,0,1,0,0,1
E02005196,1,10,4,1,0,16
E02005197,0,1,1,2,0,4
E02005198,0,9,4,0,0,13
E02005199,0,3,2,0,0,5
E02005200,0,0,2,1,1,4
E02005201,0,3,4,5,2,14
E02005202,0,8,4,1,0,13
E02005203,1,1,0,2,0,4
E02005204,0,6,2,4,0,12
E02005205,0,1,1,1,0,3
E02005206,0,8,4,2,0,14
E02005207,1,7,3,1,0,12
E02005208,0,9,5,2,0,16
E02005209,0,4,5,0,1,10
E02005210,0,8,7,1,0,16
E02005211,1,2,2,2,1,8
E02005212,1,8,1,0,0,10
E02005213,0,6,3,2,1,12
E02005214,1,4,1,0,0,6
E02005215,1,2,2,1,1,7
E02005216,0,1,1,0,0,2
E02005217,0,3,2,0,1,6
E02005218,1,1,7,2,1,12
E02005219,0,2,1,0,1,4
E02005220,0,3,1,0,0,4
E02005221,1,12,1,0,0,14
E02005222,0,5,1,1,0,7
E02005223,1,1,1,0,0,3
E02005224,1,1,3,0,0,5
E02005225,0,1,0,0,0,1
E02005226,1,3,3,0,0,7
E02005228,0,1,0,0,0,1
E02005229,1,1,0,0,0,2
E02005230,0,0,1,0,0,1
E02005231,0,3,1,1,1,6
E02005233,0,5,0,0,0,5
E02005234,0,1,1,0,0,2
E02005235,0,0,0,0,0,0
E02005236,0,5,4,0,0,9
E02005237,0,1,0,0,0,1
E02005238,0,1,1,1,1,4
E02005239,1,1,0,0,0,2
E02005240,0,6,2,0,0,8
E02005241,0,1,3,0,0,4
E02005242,0,4,0,0,0,4
E02005243,1,6,4,1,0,12
E02005244,1,1,0,0,0,2
E02005245,1,2,1,0,0,4
E02005246,0,4,3,1,1,9
E02005247,0,2,2,0,0,4
E02005248,0,3,1,1,0,5
E02005249,0,3,1,0,0,4
E02005250,0,2,1,0,1,4
E02005251,1,4,2,1,1,9
E02005252,1,1,3,4,0,9
E02005253,1,5,2,1,0,9
E02005254,0,1,2,0,0,3
E02005255,2,5,2,0,0,9
E02005256,0,6,12,4,0,22
E02005257,0,5,7,2,0,14
E02005258,0,4,3,2,2,11
E02005259,2,1,5,0,0,8
E02005260,0,1,4,3,0,8
E02005261,3,3,3,0,0,9
E02005262,0,0,4,1,0,5
E02005263,0,5,0,1,1,7
E02005264,0,1,1,1,0,3
E02005265,0,4,3,0,0,7
E02005266,0,2,4,0,0,6
E02005267,0,1,1,0,0,2
E02005268,0,5,2,1,0,8
E02005269,0,2,0,0,0,2
E02005270,0,1,1,0,0,2
E02005271,0,1,0,3,0,4
E02005272,0,2,0,0,0,2
E02005273,0,2,0,1,0,3
E02005274,0,0,0,0,0,0
E02005275,0,2,2,0,0,4
E02005276,0,5,1,1,0,7
E02005277,0,5,0,0,0,5
E02005278,0,1,1,0,0,2
E02005279,0,1,0,0,0,1
E02005280,0,4,1,0,0,5
E02005281,1,3,4,0,0,8
E02005284,0,10,6,0,0,16
E02005285,0,2,2,1,0,5
E02005286,0,4,4,0,1,9
E02005287,0,3,1,0,0,4
E02005288,0,3,2,1,0,6
E02005289,0,0,3,0,1,4
E02005290,0,1,5,1,1,8
E02005291,1,2,0,1,0,4
E02005292,0,4,1,1,0,6
E02005293,0,4,1,1,0,6
E02005294,1,2,1,0,0,4
E02005295,0,8,1,0,0,9
E02005296,0,3,2,0,0,5
E02005297,0,3,4,4,0,11
E02005298,0,1,0,0,0,1
E02005299,0,3,2,0,0,5
E02005300,0,0,1,1,0,2
E02005301,1,3,3,2,0,9
E02005302,0,2,1,0,0,3
E02005303,0,5,1,0,0,6
E02005304,0,3,0,0,0,3
E02005305,0,6,3,0,1,10
E02005306,0,2,3,2,0,7
E02005307,0,1,3,0,1,5
E02005308,0,6,0,1,0,7
E02005309,0,5,0,1,0,6
E02005310,2,15,2,1,0,20
E02005311,0,2,1,0,0,3
E02005312,0,4,2,0,0,6
E02005313,0,7,4,0,0,11
E02005314,1,6,3,0,0,10
E02005315,0,5,1,0,1,7
E02005316,0,5,0,0,0,5
E02005317,0,6,0,0,0,6
E02005318,1,8,2,2,0,13
E02005319,0,3,3,1,0,7
E02005320,0,2,6,1,0,9
E02005321,1,3,2,1,0,7
E02005322,0,8,7,4,1,20
E02005323,0,2,2,1,0,5
E02005324,0,2,1,1,0,4
E02005325,0,5,0,0,0,5
E02005326,0,7,10,1,0,18
E02005327,0,1,1,0,0,2
E02005328,0,2,3,0,0,5
E02005329,0,3,3,2,0,8
E02005330,0,4,0,0,0,4
E02005331,0,3,9,3,1,16
E02005332,0,4,3,1,0,8
E02005334,0,1,0,0,0,1
E02005335,4,7,3,0,1,15
E02005336,0,1,1,0,0,2
E02005337,0,3,6,1,0,10
E02005338,0,6,4,1,0,11
E02005339,2,1,0,0,0,3
E02005340,1,4,3,4,0,12
E02005341,0,2,3,3,0,8
E02005342,0,2,1,1,0,4
E02005343,0,1,2,1,0,4
E02005344,0,2,2,1,0,5
E02005345,0,3,2,1,1,7
E02005346,1,1,1,2,0,5
E02005347,0,0,2,0,1,3
E02005348,0,1,4,1,1,7
E02005349,1,5,1,0,0,7
E02005350,0,11,2,1,0,14
E02005351,1,2,3,1,0,7
E02005352,1,2,2,0,0,5
E02005353,1,1,1,0,0,3
E02005354,1,3,2,0,0,6
E02005355,1,0,1,0,0,2
E02005356,0,3,2,0,0,5
E02005357,0,1,0,0,0,1
E02005358,0,3,0,0,0,3
E02005359,0,1,2,0,1,4
E02005360,0,4,0,0,0,4
E02005361,0,0,1,0,0,1
E02005362,0,1,4,0,0,5
E02005363,1,5,4,4,2,16
E02005364,1,1,0,0,0,2
E02005365,0,6,2,2,0,10
E02005366,0,1,4,1,0,6
E02005368,0,1,1,0,1,3
E02005369,1,6,3,0,0,10
E02005370,2,0,0,0,0,2
E02005371,1,1,1,0,3,6
E02005372,2,3,1,0,0,6
E02005373,1,3,0,0,0,4
E02005374,1,2,1,0,1,5
E02005375,0,8,8,0,0,16
E02005376,0,4,0,0,0,4
E02005377,0,5,2,0,0,7
E02005378,0,0,1,1,0,2
E02005379,0,2,1,0,0,3
E02005380,0,1,1,1,0,3
E02005381,0,5,5,0,0,10
E02005382,1,3,3,1,0,8
E02005383,2,5,4,2,0,13
E02005384,1,6,6,3,0,16
E02005385,0,1,1,0,1,3
E02005386,0,10,4,5,1,20
E02005387,1,0,0,1,0,2
E02005388,1,4,0,2,0,7
E02005389,1,4,0,1,1,7
E02005390,0,2,0,2,0,4
E02005391,1,3,0,0,0,4
E02005392,0,3,1,0,1,5
E02005393,0,1,5,0,0,6
E02005394,0,1,0,0,0,1
E02005395,0,3,0,0,0,3
E02005396,1,6,3,0,0,10
E02005397,0,4,0,2,0,6
E02005398,0,1,0,1,0,2
E02005399,1,4,0,1,0,6
E02005400,0,2,2,1,0,5
E02005401,1,3,1,0,0,5
E02005402,0,7,2,0,0,9
E02005403,0,2,0,0,0,2
E02005404,2,4,1,0,0,7
E02005405,0,3,0,0,1,4
E02005406,0,9,0,0,0,9
E02005407,0,2,2,0,0,4
E02005408,0,2,1,1,0,4
E02005409,0,1,2,0,1,4
E02005412,1,5,2,2,0,10
E02005414,0,8,3,3,0,14
E02005415,1,6,3,2,0,12
E02005416,0,1,1,0,0,2
E02005417,0,0,1,0,0,1
E02005418,0,1,1,0,0,2
E02005419,0,1,3,0,0,4
E02005420,0,5,0,0,0,5
E02005422,0,5,1,0,0,6
E02005423,1,4,3,2,0,10
E02005424,0,1,0,0,0,1
E02005425,0,0,0,0,1,1
E02005426,0,2,0,0,0,2
E02005427,0,1,0,0,0,1
E02005428,0,5,2,0,2,9
E02005429,1,2,2,0,0,5
E02005430,0,0,0,0,0,0
E02005431,0,1,0,0,0,1
E02005432,0,1,0,0,0,1
E02005433,0,3,2,0,0,5
E02005434,0,3,1,1,0,5
E02005435,0,3,0,0,0,3
E02005436,1,0,1,1,1,4
E02005437,1,1,1,0,0,3
E02005438,0,4,2,1,0,7
E02005439,1,0,1,1,0,3
E02005440,0,1,0,0,0,1
E02005441,0,1,1,1,0,3
E02005442,0,0,0,0,0,0
E02005443,0,0,1,0,0,1
E02005444,2,7,4,1,0,14
E02005445,0,0,0,0,0,0
E02005446,0,0,0,0,0,0
E02005447,0,1,0,2,0,3
E02005448,0,2,0,0,0,2
E02005449,0,1,0,0,0,1
E02005450,0,1,0,0,0,1
E02005451,0,3,0,0,0,3
E02005452,1,0,1,0,1,3
E02005453,0,1,0,0,1,2
E02005455,1,6,0,0,0,7
E02005456,0,7,0,0,0,7
E02005457,0,2,0,1,0,3
E02005458,0,2,0,0,0,2
E02005459,0,1,0,1,0,2
E02005460,0,0,0,0,0,0
E02005461,0,4,0,0,0,4
E02005462,0,6,0,0,0,6
E02005463,0,1,0,0,0,1
E02005464,0,5,0,0,0,5
E02005465,1,2,4,1,0,8
E02005466,1,2,0,0,0,3
E02005467,0,2,0,0,1,3
E02005468,0,2,0,1,0,3
E02005469,1,1,3,0,0,5
E02005470,0,2,2,0,0,4
E02005471,0,0,1,0,0,1
E02005472,0,6,4,3,0,13
E02005473,1,0,11,2,0,14
E02005474,0,3,0,0,0,3
E02005475,0,1,0,0,0,1
E02005476,0,1,0,0,0,1
E02005477,2,2,2,0,0,6
E02005478,0,0,1,0,0,1
E02005479,0,5,0,1,0,6
E02005480,0,1,0,0,0,1
E02005481,0,2,2,0,0,4
E02005482,0,1,0,0,0,1
E02005483,0,1,0,1,0,2
E02005484,0,1,1,0,0,2
E02005485,0,7,4,1,0,12
E02005486,0,8,1,0,0,9
E02005487,1,1,1,1,0,4
E02005488,0,0,3,1,0,4
E02005489,0,1,2,3,0,6
E02005490,0,2,0,3,0,5
E02005491,1,2,2,0,0,5
E02005492,0,3,0,0,0,3
E02005493,0,0,2,0,0,2
E02005494,0,3,1,0,0,4
E02005495,0,3,1,0,0,4
E02005496,0,1,0,0,0,1
E02005497,0,1,1,0,0,2
E02005498,0,0,0,0,0,0
E02005499,0,1,0,0,0,1
E02005500,0,1,0,0,0,1
E02005501,0,1,1,0,0,2
E02005502,0,3,0,0,0,3
E02005503,1,1,1,0,0,3
E02005504,0,3,1,0,0,4
E02005505,0,5,0,0,0,5
E02005506,0,0,1,0,0,1
E02005507,0,3,0,0,0,3
E02005508,0,5,0,0,0,5
E02005509,0,11,13,0,1,25
E02005510,0,5,2,0,0,7
E02005511,0,1,1,0,0,2
E02005512,1,5,4,1,0,11
E02005513,0,3,6,0,1,10
E02005514,0,2,2,0,0,4
E02005515,0,3,1,0,0,4
E02005516,0,1,0,0,0,1
E02005517,1,0,0,0,0,1
E02005518,0,2,2,1,0,5
E02005519,0,0,1,0,0,1
E02005520,1,0,1,0,0,2
E02005521,0,1,0,0,0,1
E02005522,0,0,3,1,0,4
E02005523,0,3,0,0,0,3
E02005524,0,2,2,0,0,4
E02005525,0,1,2,1,1,5
E02005526,1,0,3,0,0,4
E02005527,0,6,3,0,0,9
E02005528,1,0,0,0,0,1
E02005529,0,3,0,0,0,3
E02005530,0,1,0,0,0,1
E02005531,0,3,0,0,0,3
E02005532,0,1,1,0,0,2
E02005533,0,4,2,1,0,7
E02005534,0,0,0,0,0,0
E02005535,0,5,9,0,0,14
E02005536,0,2,2,0,0,4
E02005537,0,2,3,0,0,5
E02005538,0,3,1,0,0,4
E02005539,0,5,4,4,0,13
E02005540,0,5,0,2,0,7
E02005541,0,2,1,1,0,4
E02005542,0,1,0,0,0,1
E02005543,0,3,0,1,0,4
E02005544,0,1,1,1,0,3
E02005545,0,1,1,0,0,2
E02005546,0,1,0,0,0,1
E02005547,1,2,0,0,0,3
E02005548,0,1,0,0,0,1
E02005549,1,2,0,0,0,3
E02005550,0,3,0,0,0,3
E02005551,0,3,3,0,0,6
E02005552,1,3,2,0,0,6
E02005553,0,5,5,0,0,10
E02005554,1,2,5,0,0,8
E02005555,0,4,3,0,0,7
E02005556,1,6,5,1,0,13
E02005557,0,4,1,0,0,5
E02005558,0,6,0,0,0,6
E02005559,1,5,3,2,0,11
E02005560,0,4,3,0,0,7
E02005561,1,8,0,0,0,9
E02005562,0,6,1,0,0,7
E02005563,1,2,4,0,0,7
E02005564,0,4,5,0,0,9
E02005565,0,2,1,0,0,3
E02005566,2,2,0,1,0,5
E02005567,1,10,3,0,0,14
E02005568,0,3,0,0,0,3
E02005569,1,4,1,0,0,6
E02005570,1,2,0,0,0,3
E02005571,0,2,2,0,0,4
E02005572,0,4,5,1,0,10
E02005573,0,2,0,0,0,2
E02005574,0,0,3,0,0,3
E02005575,0,2,0,0,0,2
E02005576,1,4,0,0,0,5
E02005577,0,0,0,0,0,0
E02005578,1,0,2,0,0,3
E02005579,0,5,2,1,0,8
E02005580,0,3,1,1,0,5
E02005581,0,1,1,0,0,2
E02005582,0,3,1,0,0,4
E02005583,0,1,1,0,0,2
E02005584,0,0,1,0,0,1
E02005585,0,2,1,0,0,3
E02005586,1,0,0,0,0,1
E02005587,0,0,0,1,0,1
E02005588,0,2,3,1,0,6
E02005589,0,1,1,0,0,2
E02005590,0,1,2,0,0,3
E02005592,0,2,0,0,0,2
E02005593,0,2,1,0,0,3
E02005594,0,0,0,0,0,0
E02005595,0,0,0,0,0,0
E02005596,0,1,0,1,0,2
E02005597,0,0,0,0,0,0
E02005598,0,1,0,0,0,1
E02005599,0,0,1,0,0,1
E02005600,0,0,0,0,1,1
E02005601,1,2,1,0,0,4
E02005602,0,3,4,0,0,7
E02005603,0,4,2,2,0,8
E02005604,0,2,0,0,0,2
E02005605,1,0,0,0,0,1
E02005606,0,0,0,1,0,1
E02005607,0,1,2,0,1,4
E02005608,0,7,11,0,0,18
E02005609,2,2,2,0,0,6
E02005610,0,3,0,0,0,3
E02005611,0,2,0,0,0,2
E02005612,0,0,1,2,0,3
E02005613,0,4,3,0,0,7
E02005614,0,6,3,1,0,10
E02005615,0,4,4,0,0,8
E02005616,0,2,3,1,0,6
E02005617,0,4,1,2,0,7
E02005619,0,1,0,1,1,3
E02005620,0,5,4,2,0,11
E02005621,0,5,1,1,0,7
E02005622,0,0,0,1,0,1
E02005623,0,4,3,4,0,11
E02005624,0,2,0,2,0,4
E02005625,2,9,3,3,0,17
E02005626,2,2,1,0,0,5
E02005627,1,4,2,1,1,9
E02005628,1,6,2,0,0,9
E02005629,0,0,1,0,0,1
E02005630,1,12,2,1,1,17
E02005631,1,4,2,1,0,8
E02005632,2,12,2,3,0,19
E02005633,0,7,1,2,0,10
E02005634,0,5,3,2,0,10
E02005635,1,1,5,1,1,9
E02005636,0,5,3,1,0,9
E02005637,0,4,4,1,1,10
E02005638,1,4,0,1,0,6
E02005639,0,3,4,0,0,7
E02005640,1,5,7,5,4,22
E02005641,1,2,2,2,1,8
E02005642,0,2,3,0,1,6
E02005643,1,1,2,0,0,4
E02005644,0,2,2,0,0,4
E02005645,1,9,11,2,1,24
E02005646,1,0,1,3,1,6
E02005647,0,0,5,2,0,7
E02005648,2,3,3,0,0,8
E02005649,0,4,6,1,0,11
E02005650,0,6,5,0,1,12
E02005651,1,3,3,1,0,8
E02005652,0,2,18,3,0,23
E02005653,1,9,1,1,0,12
E02005654,0,1,1,1,1,4
E02005655,0,4,2,1,0,7
E02005656,0,1,0,1,1,3
E02005657,0,4,1,0,0,5
E02005658,1,1,1,0,0,3
E02005659,1,3,3,3,0,10
E02005660,0,4,3,1,0,8
E02005661,0,3,3,2,0,8
E02005662,1,2,5,0,0,8
E02005663,0,1,3,1,0,5
E02005664,0,23,2,3,0,28
E02005665,0,3,1,0,0,4
E02005666,0,2,3,2,1,8
E02005667,0,13,5,2,0,20
E02005668,0,9,4,1,1,15
E02005669,1,4,0,1,0,6
E02005670,0,1,1,0,0,2
E02005671,1,4,1,0,0,6
E02005672,0,0,0,2,0,2
E02005673,0,6,3,2,0,11
E02005674,2,10,6,2,1,21
E02005675,0,2,1,1,0,4
E02005676,1,1,0,3,0,5
E02005677,0,0,2,1,0,3
E02005678,0,2,2,0,1,5
E02005679,0,5,4,1,0,10
E02005680,1,4,5,0,0,10
E02005681,0,5,3,1,1,10
E02005682,0,3,1,0,0,4
E02005683,0,4,2,2,1,9
E02005684,0,5,0,2,0,7
E02005685,0,2,1,2,0,5
E02005686,0,6,1,0,0,7
E02005687,0,0,0,0,0,0
E02005688,2,5,0,0,0,7
E02005689,0,1,3,0,0,4
E02005690,0,0,1,0,0,1
E02005691,1,2,1,0,0,4
E02005692,0,1,0,0,0,1
E02005693,0,3,1,0,0,4
E02005694,0,2,1,0,0,3
E02005695,0,4,7,0,0,11
E02005696,1,4,3,0,0,8
E02005697,1,9,3,1,1,15
E02005698,0,3,2,0,0,5
E02005699,0,2,0,0,0,2
E02005700,0,2,5,2,0,9
E02005701,0,6,2,1,2,11
E02005702,1,6,3,0,0,10
E02005703,0,3,0,0,0,3
E02005704,1,10,5,1,0,17
E02005705,1,1,1,0,0,3
E02005706,0,4,0,0,1,5
E02005707,1,3,1,0,0,5
E02005708,0,5,0,0,0,5
E02005709,0,13,8,0,0,21
E02005710,0,11,8,2,0,21
E02005711,0,5,1,2,1,9
E02005712,0,4,0,0,0,4
E02005713,0,1,1,1,0,3
E02005714,0,1,0,0,0,1
E02005715,0,11,19,4,0,34
E02005716,0,3,5,0,0,8
E02005717,0,4,3,0,0,7
E02005718,1,6,2,0,0,9
E02005719,0,2,2,0,0,4
E02005720,0,1,4,1,0,6
E02005721,1,1,1,0,1,4
E02005722,1,2,1,0,0,4
E02005723,0,3,1,0,0,4
E02005724,0,4,3,1,1,9
E02005725,0,1,3,2,1,7
E02005726,0,1,1,0,0,2
E02005727,0,2,1,0,0,3
E02005728,0,3,0,0,0,3
E02005729,0,1,1,0,0,2
E02005730,1,3,0,0,0,4
E02005731,0,7,0,0,0,7
E02005732,0,2,0,0,0,2
E02005733,0,0,0,0,0,0
E02005734,0,6,2,1,0,9
E02005735,0,3,3,1,0,7
E02005736,0,3,0,0,0,3
E02005737,0,1,0,0,0,1
E02005738,0,0,0,0,0,0
E02005739,1,9,7,0,1,18
E02005740,0,2,4,0,0,6
E02005741,0,7,0,4,0,11
E02005742,3,2,1,0,0,6
E02005743,0,3,0,0,0,3
E02005744,1,6,1,1,0,9
E02005745,0,4,1,1,1,7
E02005746,0,3,0,1,0,4
E02005747,0,9,4,0,0,13
E02005748,0,5,1,0,0,6
E02005749,0,12,6,1,0,19
E02005750,0,7,2,2,0,11
E02005751,0,3,0,1,0,4
E02005752,0,5,2,0,0,7
E02005753,0,8,0,3,0,11
E02005754,0,15,0,0,1,16
E02005755,1,1,2,0,0,4
E02005756,0,1,1,0,0,2
E02005757,1,5,0,1,0,7
E02005758,0,3,1,1,0,5
E02005759,0,2,2,0,1,5
E02005760,0,0,0,1,0,1
E02005761,0,1,1,2,0,4
E02005762,0,0,4,2,0,6
E02005763,0,1,0,0,0,1
E02005764,0,10,4,1,1,16
E02005765,0,5,8,1,0,14
E02005766,0,0,0,0,0,0
E02005767,0,3,10,4,0,17
E02005768,0,1,0,0,0,1
E02005769,1,3,1,0,1,6
E02005770,0,0,1,1,1,3
E02005771,0,3,2,2,0,7
E02005772,0,2,0,0,1,3
E02005773,2,6,1,1,0,10
E02005774,0,5,5,19,2,31
E02005775,0,17,5,4,1,27
E02005776,3,1,2,3,1,10
E02005777,0,13,0,0,0,13
E02005778,0,2,3,0,1,6
E02005779,0,6,1,1,1,9
E02005780,0,4,2,0,0,6
E02005781,0,9,5,0,0,14
E02005782,1,4,3,1,0,9
E02005783,0,4,4,0,0,8
E02005784,3,5,2,4,0,14
E02005785,0,3,12,1,0,16
E02005786,0,1,0,0,0,1
E02005787,0,2,0,0,1,3
E02005788,1,4,0,0,0,5
E02005789,0,3,1,0,0,4
E02005790,0,5,0,1,0,6
E02005791,0,0,1,0,0,1
E02005794,0,5,1,0,0,6
E02005795,0,1,0,0,1,2
E02005796,0,1,0,0,0,1
E02005797,1,1,2,0,0,4
E02005798,0,4,1,0,0,5
E02005799,0,3,3,0,0,6
E02005800,0,5,0,0,0,5
E02005801,0,1,1,0,0,2
E02005802,1,5,4,1,0,11
E02005803,1,3,3,2,0,9
E02005804,0,13,6,1,1,21
E02005805,0,2,1,0,0,3
E02005806,0,1,2,0,0,3
E02005807,0,6,0,1,0,7
E02005808,0,4,2,0,0,6
E02005809,0,2,1,2,0,5
E02005810,0,2,0,0,0,2
E02005811,0,2,1,0,0,3
E02005812,1,0,1,0,0,2
E02005813,0,3,5,0,0,8
E02005814,0,1,1,1,0,3
E02005815,0,2,0,0,0,2
E02005816,1,4,6,1,0,12
E02005817,0,1,3,0,1,5
E02005818,0,3,1,0,0,4
E02005819,0,6,0,0,0,6
E02005820,0,2,0,0,0,2
E02005821,1,2,0,0,0,3
E02005822,1,5,11,1,0,18
E02005823,1,12,1,1,0,15
E02005824,2,4,1,0,0,7
E02005825,0,2,7,0,0,9
E02005826,0,4,1,0,0,5
E02005827,0,10,6,0,2,18
E02005828,1,1,1,0,0,3
E02005829,1,11,6,1,2,21
E02005830,0,1,2,0,0,3
E02005831,0,3,1,0,0,4
E02005832,0,9,3,1,0,13
E02005833,0,3,1,0,0,4
E02005834,3,10,3,0,0,16
E02005835,0,13,1,0,1,15
E02005836,0,4,1,1,0,6
E02005837,0,0,0,2,1,3
E02005838,0,5,2,1,0,8
E02005839,0,2,2,4,0,8
E02005840,0,1,2,1,0,4
E02005842,0,1,0,0,0,1
E02005843,0,3,0,0,0,3
E02005844,0,0,2,1,0,3
E02005846,0,1,2,0,0,3
E02005847,0,1,3,1,0,5
E02005848,0,3,0,1,0,4
E02005849,0,0,3,0,1,4
E02005850,1,7,9,0,0,17
E02005851,0,5,0,0,0,5
E02005852,1,3,3,1,0,8
E02005853,1,3,0,0,0,4
E02005856,2,5,0,1,0,8
E02005857,0,2,1,0,0,3
E02005858,0,1,1,0,0,2
E02005859,0,0,0,1,0,1
E02005860,2,13,3,1,1,20
E02005861,0,3,0,0,0,3
E02005862,0,1,2,1,0,4
E02005863,0,5,4,0,1,10
E02005864,0,2,0,1,0,3
E02005865,1,0,0,0,0,1
E02005866,2,2,2,1,0,7
E02005868,0,7,1,0,0,8
E02005869,0,4,2,0,0,6
E02005870,0,2,1,0,0,3
E02005871,1,4,2,1,0,8
E02005872,0,6,2,0,0,8
E02005873,0,15,5,1,0,21
E02005874,0,3,0,0,0,3
E02005875,0,2,11,1,0,14
E02005876,1,17,0,0,0,18
E02005877,1,2,1,0,1,5
E02005878,1,3,1,1,1,7
E02005879,1,1,0,0,0,2
E02005880,0,2,0,0,0,2
E02005881,1,1,1,1,0,4
E02005882,1,1,1,0,0,3
E02005883,0,4,0,0,0,4
E02005884,0,3,2,1,0,6
E02005885,0,5,2,0,0,7
E02005886,0,2,1,0,0,3
E02005887,0,3,2,1,0,6
E02005888,3,4,0,6,1,14
E02005889,5,3,0,1,1,10
E02005890,0,5,1,0,0,6
E02005891,0,3,0,0,0,3
E02005892,0,7,1,1,1,10
E02005893,0,1,0,1,0,2
E02005894,0,15,2,0,1,18
E02005895,0,1,0,0,0,1
E02005896,0,1,1,1,0,3
E02005897,2,7,1,0,0,10
E02005898,0,5,0,0,0,5
E02005899,0,3,2,0,0,5
E02005900,0,6,0,1,1,8
E02005901,0,4,1,0,0,5
E02005902,1,2,0,1,0,4
E02005903,1,1,0,1,0,3
E02005904,0,4,6,0,0,10
E02005905,1,1,2,0,0,4
E02005906,1,5,0,0,0,6
E02005907,0,7,1,1,0,9
E02005908,0,1,5,0,0,6
E02005909,0,6,1,0,0,7
E02005910,2,0,1,0,0,3
E02005911,0,2,5,1,0,8
E02005912,0,2,3,1,0,6
E02005913,0,1,1,2,1,5
E02005914,1,7,1,1,0,10
E02005915,1,2,1,0,0,4
E02005916,0,2,3,0,0,5
E02005917,1,5,1,1,0,8
E02005918,0,5,1,0,0,6
E02005919,0,1,1,0,0,2
E02005920,0,2,0,0,0,2
E02005921,0,2,1,0,0,3
E02005922,1,3,0,0,0,4
E02005923,0,2,1,0,0,3
E02005924,0,7,4,1,0,12
E02005925,1,2,4,0,0,7
E02005926,0,5,1,0,0,6
E02005927,1,3,0,0,1,5
E02005928,0,7,1,0,0,8
E02005929,0,1,0,0,0,1
E02005930,1,1,1,0,0,3
E02005931,1,10,3,0,1,15
E02005932,0,0,0,0,0,0
E02005933,0,1,0,0,0,1
E02005934,1,2,0,0,0,3
E02005935,1,3,0,0,0,4
E02005936,0,1,6,0,0,7
E02005937,0,16,1,0,0,17
E02005938,0,12,0,0,0,12
E02005939,0,3,2,0,0,5
E02005940,0,2,0,0,0,2
E02005941,0,4,1,0,0,5
E02005942,0,0,1,0,0,1
E02005943,0,9,0,0,0,9
E02005944,0,3,2,0,0,5
E02005945,0,8,1,0,0,9
E02005946,1,1,0,1,0,3
E02005947,1,0,0,0,0,1
E02005948,0,1,0,0,1,2
E02005949,0,1,0,0,0,1
E02005950,0,0,0,0,0,0
E02005951,1,1,0,0,0,2
E02005952,1,3,0,0,0,4
E02005953,0,1,0,0,0,1
E02005954,2,6,3,3,0,14
E02005955,0,3,0,0,0,3
E02005956,1,3,1,0,0,5
E02005957,1,7,0,1,0,9
E02005958,0,0,1,0,0,1
E02005959,2,1,2,0,0,5
E02005960,1,1,4,0,1,7
E02005961,1,2,0,0,0,3
E02005962,0,4,4,1,0,9
E02005963,2,3,0,0,0,5
E02005964,0,4,2,0,0,6
E02005965,0,10,1,0,0,11
E02005966,0,0,0,0,0,0
E02005967,0,0,4,2,0,6
E02005968,0,4,2,1,0,7
E02005969,0,6,1,0,0,7
E02005970,0,1,1,0,0,2
E02005971,0,1,1,0,0,2
E02005972,0,1,1,1,0,3
E02005973,0,15,2,0,0,17
E02005974,1,4,1,0,0,6
E02005975,0,2,0,0,0,2
E02005976,0,5,0,0,0,5
E02005977,1,1,11,0,0,13
E02005978,2,7,1,1,0,11
E02005979,0,4,2,0,0,6
E02005980,1,8,5,0,1,15
E02005981,0,2,0,0,0,2
E02005982,0,0,0,0,0,0
E02005983,1,17,2,0,0,20
E02005984,0,1,1,0,0,2
E02005985,1,4,0,0,0,5
E02005986,3,15,0,0,0,18
E02005987,0,3,0,0,0,3
E02005988,0,1,2,0,0,3
E02005991,0,10,8,0,1,19
E02005992,0,3,0,1,0,4
E02005993,2,14,8,3,1,28
E02005994,1,3,2,0,0,6
E02005995,0,3,1,0,0,4
E02005996,0,5,0,1,0,6
E02005997,1,3,0,0,0,4
E02005998,0,4,0,0,0,4
E02005999,0,4,2,0,0,6
E02006000,0,21,4,0,0,25
E02006001,0,5,1,0,0,6
E02006002,2,4,3,0,0,9
E02006003,0,0,0,0,0,0
E02006004,1,2,5,2,0,10
E02006005,1,4,0,0,0,5
E02006006,0,2,1,0,0,3
E02006007,0,2,1,0,0,3
E02006008,0,0,2,0,0,2
E02006009,2,4,4,0,0,10
E02006010,0,4,1,3,0,8
E02006011,1,2,4,0,0,7
E02006012,0,2,3,1,0,6
E02006013,0,5,3,1,0,9
E02006014,6,11,3,0,1,21
E02006015,0,5,4,4,1,14
E02006016,1,0,0,1,0,2
E02006017,0,0,2,0,2,4
E02006018,0,3,2,3,0,8
E02006019,0,1,4,0,0,5
E02006020,2,0,0,0,0,2
E02006021,0,1,2,0,0,3
E02006022,1,2,3,0,0,6
E02006023,1,1,2,3,0,7
E02006024,0,4,6,2,2,14
E02006025,1,3,0,1,0,5
E02006026,0,2,2,0,0,4
E02006027,0,1,0,1,0,2
E02006028,0,1,8,2,0,11
E02006029,1,2,1,2,0,6
E02006030,0,2,9,2,0,13
E02006031,1,2,4,6,1,14
E02006032,0,2,1,0,0,3
E02006033,0,3,5,1,1,10
E02006034,0,5,3,0,0,8
E02006035,1,0,2,0,0,3
E02006036,1,1,1,0,0,3
E02006037,0,2,4,1,0,7
E02006038,1,2,2,0,0,5
E02006039,0,6,3,1,0,10
E02006040,0,2,0,0,0,2
E02006041,0,1,1,0,0,2
E02006042,0,3,2,0,0,5
E02006043,2,1,1,1,0,5
E02006044,0,1,0,0,0,1
E02006045,0,4,4,0,1,9
E02006046,1,2,0,1,0,4
E02006047,0,1,0,0,0,1
E02006048,1,0,0,0,0,1
E02006049,0,0,1,0,0,1
E02006050,0,0,0,0,0,0
E02006051,0,3,0,0,0,3
E02006052,0,2,2,0,0,4
E02006053,0,2,6,0,0,8
E02006054,1,1,1,0,0,3
E02006055,0,1,0,0,0,1
E02006056,0,2,0,1,0,3
E02006057,0,0,0,0,0,0
E02006058,0,1,0,0,0,1
E02006059,0,0,0,0,0,0
E02006060,1,0,1,0,0,2
E02006061,0,2,2,1,0,5
E02006062,1,3,2,0,0,6
E02006063,0,0,0,0,1,1
E02006064,1,6,6,0,0,13
E02006065,0,3,2,1,0,6
E02006066,0,2,1,0,0,3
E02006067,1,0,2,0,0,3
E02006068,0,0,0,1,0,1
E02006069,1,3,1,1,0,6
E02006070,0,0,1,1,0,2
E02006071,0,8,2,0,0,10
E02006072,0,2,3,0,0,5
E02006073,0,3,3,0,0,6
E02006074,0,2,0,0,0,2
E02006075,0,0,0,0,0,0
E02006076,0,5,1,0,1,7
E02006077,0,1,0,0,0,1
E02006078,0,2,0,0,0,2
E02006079,0,2,2,0,0,4
E02006080,0,1,0,0,0,1
E02006081,0,4,2,1,0,7
E02006082,0,1,0,0,0,1
E02006083,0,0,0,0,0,0
E02006084,0,0,0,0,0,0
E02006085,0,2,0,0,0,2
E02006086,0,1,0,0,0,1
E02006087,0,4,3,0,0,7
E02006088,1,1,1,0,0,3
E02006089,0,1,0,3,0,4
E02006090,0,0,0,0,0,0
E02006091,0,1,0,0,0,1
E02006092,0,1,0,0,0,1
E02006093,0,4,1,0,0,5
E02006094,0,0,0,0,0,0
E02006095,0,1,4,1,0,6
E02006096,0,1,0,1,0,2
E02006097,0,1,0,0,0,1
E02006098,0,1,1,0,0,2
E02006099,0,3,0,0,0,3
E02006100,0,3,1,0,0,4
E02006101,0,2,0,0,0,2
E02006102,0,1,0,0,0,1
E02006103,0,1,2,0,0,3
E02006104,0,0,0,0,0,0
E02006105,0,0,1,0,0,1
E02006106,0,3,2,0,0,5
E02006107,0,0,0,0,0,0
E02006108,1,0,2,0,0,3
E02006109,0,0,1,0,0,1
E02006110,1,0,0,0,0,1
E02006111,1,5,2,0,0,8
E02006112,0,0,1,0,0,1
E02006113,0,4,0,0,0,4
E02006114,1,2,0,1,0,4
E02006115,0,1,1,1,0,3
E02006116,0,1,0,0,0,1
E02006117,0,1,1,0,0,2
E02006118,1,2,2,0,0,5
E02006119,0,5,5,0,0,10
E02006120,1,4,3,0,0,8
E02006121,0,0,0,0,0,0
E02006122,0,2,1,3,0,6
E02006123,0,4,1,0,1,6
E02006124,0,8,0,1,1,10
E02006125,0,1,1,0,0,2
E02006126,0,7,0,1,0,8
E02006127,1,8,0,0,0,9
E02006128,2,3,1,0,0,6
E02006129,0,3,3,0,0,6
E02006130,1,3,0,0,0,4
E02006131,1,12,2,1,0,16
E02006132,1,2,1,1,0,5
E02006133,1,4,1,0,0,6
E02006134,0,9,7,1,1,18
E02006135,2,5,1,0,0,8
E02006136,1,17,1,1,0,20
E02006137,1,19,1,1,0,22
E02006138,1,4,0,0,0,5
E02006139,0,1,1,0,1,3
E02006140,0,7,4,2,1,14
E02006141,0,11,1,1,0,13
E02006142,0,1,3,0,1,5
E02006143,3,2,0,0,0,5
E02006144,0,10,1,0,0,11
E02006145,1,4,2,0,1,8
E02006146,1,7,1,0,0,9
E02006147,0,9,2,0,0,11
E02006148,1,2,2,0,1,6
E02006149,1,13,3,1,0,18
E02006150,2,18,1,1,1,23
E02006151,1,2,0,0,0,3
E02006152,1,4,1,1,0,7
E02006153,1,4,3,2,0,10
E02006154,0,9,1,0,0,10
E02006155,0,2,1,0,0,3
E02006156,1,7,3,0,1,12
E02006157,0,2,5,1,0,8
E02006158,0,2,1,1,0,4
E02006159,0,3,6,2,0,11
E02006160,0,4,2,0,0,6
E02006161,2,4,2,0,0,8
E02006162,0,5,3,0,0,8
E02006163,2,14,3,0,4,23
E02006164,0,10,4,4,2,20
E02006165,2,1,3,0,0,6
E02006166,0,1,2,1,0,4
E02006167,0,9,3,1,0,13
E02006168,1,8,7,1,0,17
E02006169,0,3,0,1,1,5
E02006170,0,1,0,1,0,2
E02006171,0,3,2,0,0,5
E02006172,1,2,3,0,0,6
E02006173,0,2,1,3,0,6
E02006174,0,1,2,0,0,3
E02006175,1,4,3,1,0,9
E02006176,2,1,1,1,0,5
E02006177,0,8,1,1,1,11
E02006178,0,1,3,1,1,6
E02006179,1,8,0,2,0,11
E02006180,3,7,2,2,1,15
E02006181,0,3,1,1,0,5
E02006182,1,7,1,1,1,11
E02006183,2,2,0,0,0,4
E02006184,1,0,1,0,0,2
E02006185,1,4,0,0,0,5
E02006186,3,12,0,0,0,15
E02006187,1,2,0,0,0,3
E02006188,0,1,4,0,0,5
E02006189,0,11,2,2,0,15
E02006190,0,7,5,0,0,12
E02006191,0,3,3,2,0,8
E02006192,0,4,3,1,0,8
E02006193,0,1,1,0,0,2
E02006194,0,8,2,3,0,13
E02006195,0,0,0,0,0,0
E02006196,0,0,2,2,0,4
E02006197,0,7,8,0,0,15
E02006198,0,2,1,3,0,6
E02006199,0,11,3,0,0,14
E02006200,0,2,1,0,0,3
E02006201,0,4,2,0,0,6
E02006202,0,3,5,0,0,8
E02006203,1,0,0,0,0,1
E02006204,0,2,2,1,1,6
E02006205,1,1,1,0,1,4
E02006206,0,2,1,1,0,4
E02006207,0,3,4,2,0,9
E02006208,0,4,1,2,0,7
E02006209,1,11,1,1,0,14
E02006210,0,4,0,0,0,4
E02006211,0,1,1,0,0,2
E02006212,1,3,4,2,2,12
E02006213,0,0,0,0,0,0
E02006214,1,1,1,1,0,4
E02006215,2,1,3,2,0,8
E02006216,0,3,2,0,0,5
E02006217,1,4,0,1,1,7
E02006218,2,7,4,1,0,14
E02006219,1,2,1,1,0,5
E02006220,4,5,1,0,1,11
E02006221,1,1,2,2,1,7
E02006222,0,4,1,1,0,6
E02006223,0,4,0,2,0,6
E02006224,0,1,2,0,0,3
E02006225,1,4,0,2,1,8
E02006226,1,4,0,0,0,5
E02006227,0,1,1,0,0,2
E02006228,0,2,0,0,0,2
E02006229,0,2,1,2,0,5
E02006230,0,2,0,0,0,2
E02006231,1,7,0,2,0,10
E02006232,0,1,0,0,0,1
E02006233,2,1,1,0,0,4
E02006234,0,0,1,2,0,3
E02006235,0,9,3,0,0,12
E02006236,0,7,0,0,0,7
E02006237,1,9,1,0,0,11
E02006238,0,5,5,1,0,11
E02006239,0,0,0,0,1,1
E02006240,0,0,0,0,0,0
E02006241,1,0,2,0,0,3
E02006242,0,1,1,1,0,3
E02006243,0,1,0,0,0,1
E02006245,0,2,1,0,0,3
E02006246,0,8,6,1,0,15
E02006247,0,2,1,0,0,3
E02006248,0,4,0,0,0,4
E02006249,4,2,4,0,0,10
E02006250,1,13,1,0,0,15
E02006251,0,5,2,0,0,7
E02006252,2,6,3,0,0,11
E02006253,1,4,2,0,0,7
E02006254,0,4,2,2,1,9
E02006255,0,2,2,0,0,4
E02006256,0,8,2,1,0,11
E02006257,0,5,1,0,0,6
E02006258,0,9,6,0,0,15
E02006259,0,1,0,0,0,1
E02006260,0,5,0,0,0,5
E02006261,0,1,3,1,0,5
E02006262,0,0,1,0,0,1
E02006263,0,2,1,0,0,3
E02006264,0,0,1,0,0,1
E02006265,1,3,3,0,0,7
E02006266,0,3,2,1,0,6
E02006267,0,5,1,0,0,6
E02006268,0,5,3,3,0,11
E02006269,0,9,3,1,0,13
E02006270,0,2,5,0,0,7
E02006271,1,2,0,2,0,5
E02006272,1,8,0,2,1,12
E02006273,0,1,1,0,0,2
E02006274,1,0,0,0,0,1
E02006275,0,0,0,0,0,0
E02006276,0,6,2,2,0,10
E02006277,0,0,1,0,0,1
E02006278,0,6,3,0,0,9
E02006279,0,1,0,0,0,1
E02006280,1,5,1,1,0,8
E02006281,0,3,3,0,0,6
E02006282,0,0,0,1,0,1
E02006283,0,1,2,0,0,3
E02006284,0,1,1,0,0,2
E02006285,0,1,0,0,0,1
E02006286,2,2,6,0,1,11
E02006287,0,0,0,0,0,0
E02006288,0,3,0,1,0,4
E02006289,0,2,5,0,0,7
E02006290,0,4,1,1,0,6
E02006291,0,2,2,0,0,4
E02006292,2,4,0,2,0,8
E02006293,1,1,4,0,0,6
E02006294,1,5,2,0,0,8
E02006295,1,7,1,0,0,9
E02006296,0,7,2,0,0,9
E02006297,2,8,0,0,0,10
E02006298,1,3,1,0,0,5
E02006299,0,4,5,1,0,10
E02006300,0,1,2,0,0,3
E02006301,1,4,0,0,0,5
E02006302,0,2,1,0,0,3
E02006303,0,7,9,0,0,16
E02006304,1,11,0,0,0,12
E02006305,0,11,1,0,0,12
E02006306,1,3,4,1,0,9
E02006307,0,7,0,0,0,7
E02006308,1,3,4,0,0,8
E02006309,2,9,1,1,0,13
E02006310,1,4,0,0,0,5
E02006311,1,6,7,0,0,14
E02006312,1,6,3,0,0,10
E02006313,0,4,0,1,0,5
E02006314,0,1,5,0,0,6
E02006315,0,1,1,0,0,2
E02006316,0,2,4,0,0,6
E02006317,0,3,1,0,0,4
E02006318,0,6,0,1,0,7
E02006319,1,10,2,0,0,13
E02006320,1,0,0,0,0,1
E02006321,0,5,3,3,1,12
E02006322,0,3,0,0,0,3
E02006323,0,3,1,0,1,5
E02006324,3,3,0,0,0,6
E02006325,0,2,0,0,0,2
E02006326,2,5,1,1,0,9
E02006327,0,3,0,0,0,3
E02006328,2,4,0,1,0,7
E02006329,0,2,1,0,0,3
E02006330,0,4,2,0,0,6
E02006331,2,3,0,0,0,5
E02006332,0,6,3,2,0,11
E02006333,0,5,1,2,1,9
E02006334,4,3,0,1,0,8
E02006335,0,4,0,0,0,4
E02006336,1,1,0,0,0,2
E02006337,1,4,1,0,0,6
E02006338,1,3,0,0,0,4
E02006339,1,14,0,1,0,16
E02006341,1,11,0,1,0,13
E02006342,0,3,1,0,0,4
E02006343,0,5,4,0,0,9
E02006344,2,2,2,1,0,7
E02006345,0,2,1,0,0,3
E02006346,0,6,0,0,0,6
E02006347,0,4,0,1,0,5
E02006348,0,5,5,2,0,12
E02006349,1,3,1,0,0,5
E02006350,0,1,0,0,0,1
E02006351,0,1,2,0,0,3
E02006352,0,2,1,0,0,3
E02006353,0,1,1,2,2,6
E02006354,0,4,4,0,0,8
E02006355,0,1,1,1,0,3
E02006356,1,3,0,0,0,4
E02006357,0,1,2,0,0,3
E02006358,0,4,0,0,0,4
E02006359,0,3,0,1,0,4
E02006360,0,14,0,0,0,14
E02006361,0,1,3,0,0,4
E02006362,1,4,2,0,0,7
E02006363,2,6,0,0,0,8
E02006364,0,0,0,0,0,0
E02006365,3,8,6,0,0,17
E02006366,0,2,1,0,0,3
E02006367,2,3,0,0,0,5
E02006368,5,4,1,0,0,10
E02006369,1,10,4,2,0,17
E02006370,0,1,1,1,0,3
E02006371,1,6,3,0,0,10
E02006372,2,8,3,0,0,13
E02006373,0,2,4,0,0,6
E02006374,0,5,1,0,0,6
E02006375,1,7,2,0,0,10
E02006376,6,13,1,2,0,22
E02006377,1,2,0,0,0,3
E02006378,1,11,2,0,0,14
E02006379,1,4,0,0,0,5
E02006380,1,7,0,0,0,8
E02006381,4,4,1,0,0,9
E02006382,1,11,1,1,0,14
E02006383,2,15,5,3,0,25
E02006384,0,4,3,0,0,7
E02006385,0,2,2,2,0,6
E02006386,0,5,1,0,0,6
E02006387,1,2,0,0,0,3
E02006388,1,5,0,0,0,6
E02006389,0,2,1,0,0,3
E02006390,0,9,0,1,0,10
E02006391,0,2,1,1,0,4
E02006392,4,17,5,0,0,26
E02006393,0,3,1,1,1,6
E02006394,1,6,1,1,0,9
E02006395,0,5,1,0,0,6
E02006396,2,3,3,1,0,9
E02006397,0,4,0,2,0,6
E02006398,1,2,0,0,0,3
E02006399,1,3,1,1,0,6
E02006400,1,6,0,0,0,7
E02006401,0,9,5,1,0,15
E02006402,1,4,1,0,0,6
E02006403,0,6,0,0,1,7
E02006404,3,6,0,1,0,10
E02006405,1,6,2,0,0,9
E02006406,1,1,1,0,0,3
E02006407,0,9,1,0,0,10
E02006408,1,6,0,0,1,8
E02006409,1,2,3,1,0,7
E02006410,1,4,3,0,0,8
E02006411,1,2,0,2,2,7
E02006412,1,2,0,0,0,3
E02006413,0,11,3,0,0,14
E02006414,0,4,3,0,0,7
E02006415,0,1,0,0,1,2
E02006416,1,5,0,0,0,6
E02006417,0,2,7,0,0,9
E02006418,0,6,2,1,0,9
E02006419,1,6,0,1,0,8
E02006420,0,13,2,0,0,15
E02006421,1,4,2,0,0,7
E02006422,0,1,2,0,0,3
E02006423,0,1,4,0,0,5
E02006424,0,1,2,0,0,3
E02006425,1,6,0,2,0,9
E02006426,0,0,1,1,0,2
E02006427,0,5,8,1,0,14
E02006429,1,2,1,0,0,4
E02006430,1,11,2,0,0,14
E02006431,0,5,4,1,1,11
E02006432,1,1,1,0,0,3
E02006433,0,2,10,2,0,14
E02006434,1,6,3,2,0,12
E02006435,1,3,1,0,0,5
E02006436,0,3,1,0,0,4
E02006437,1,6,1,0,0,8
E02006438,0,4,2,0,0,6
E02006439,0,0,3,0,0,3
E02006440,0,0,1,0,0,1
E02006441,0,5,5,0,0,10
E02006442,0,3,0,0,0,3
E02006443,1,12,5,0,0,18
E02006444,0,5,1,1,0,7
E02006445,2,3,2,2,0,9
E02006446,2,7,3,0,0,12
E02006447,1,2,0,0,0,3
E02006448,1,2,0,0,0,3
E02006449,0,1,0,0,0,1
E02006450,1,9,4,0,0,14
E02006451,0,5,1,1,0,7
E02006453,0,12,3,1,0,16
E02006454,1,5,1,1,0,8
E02006455,0,4,5,2,0,11
E02006456,0,3,2,1,1,7
E02006457,0,2,3,0,0,5
E02006458,1,8,3,0,0,12
E02006459,1,3,0,1,0,5
E02006460,0,3,0,0,0,3
E02006461,0,4,3,0,0,7
E02006462,0,5,2,0,0,7
E02006463,1,6,5,2,0,14
E02006464,0,4,2,1,0,7
E02006465,0,3,1,0,0,4
E02006466,0,1,1,1,1,4
E02006467,1,0,1,0,0,2
E02006468,0,1,3,2,0,6
E02006469,0,5,2,3,1,11
E02006470,4,9,1,1,2,17
E02006471,0,7,1,2,0,10
E02006472,1,9,1,1,0,12
E02006473,2,13,3,1,0,19
E02006474,0,8,2,1,0,11
E02006475,1,5,1,0,0,7
E02006476,0,1,4,1,0,6
E02006477,3,0,0,1,0,4
E02006478,3,2,0,0,0,5
E02006479,1,4,2,4,0,11
E02006480,2,5,1,2,0,10
E02006481,1,5,2,2,1,11
E02006482,0,0,1,2,0,3
E02006483,4,10,11,2,4,31
E02006484,1,0,3,2,1,7
E02006485,3,2,1,1,0,7
E02006486,2,3,2,1,0,8
E02006487,0,3,6,1,0,10
E02006488,3,7,5,1,0,16
E02006489,0,1,2,1,1,5
E02006490,2,5,2,2,0,11
E02006492,0,7,1,1,0,9
E02006493,0,0,0,1,0,1
E02006494,0,3,5,1,0,9
E02006495,2,3,1,0,0,6
E02006496,1,1,1,1,0,4
E02006497,0,0,1,0,0,1
E02006498,0,1,2,0,0,3
E02006499,0,1,0,0,0,1
E02006500,0,2,2,0,0,4
E02006501,1,2,5,0,0,8
E02006502,0,12,9,0,0,21
E02006503,2,3,2,0,0,7
E02006504,1,4,1,1,1,8
E02006505,1,8,1,0,0,10
E02006506,0,4,5,0,0,9
E02006507,0,14,5,1,0,20
E02006508,0,4,0,0,1,5
E02006509,0,4,0,0,0,4
E02006510,0,3,5,0,0,8
E02006511,0,2,1,0,0,3
E02006512,2,17,5,0,1,25
E02006513,1,10,2,0,0,13
E02006514,1,9,3,0,0,13
E02006515,1,8,4,0,0,13
E02006516,1,13,4,0,0,18
E02006517,0,4,1,0,0,5
E02006518,0,8,5,1,0,14
E02006519,0,7,4,0,0,11
E02006520,0,7,3,0,0,10
E02006521,1,5,1,1,1,9
E02006522,0,2,0,0,0,2
E02006523,0,4,3,2,0,9
E02006524,0,3,1,2,0,6
E02006525,0,5,5,1,1,12
E02006526,0,1,0,1,0,2
E02006527,1,4,3,0,0,8
E02006528,0,4,2,1,0,7
E02006529,0,4,0,0,0,4
E02006530,0,7,0,0,1,8
E02006531,2,3,2,0,0,7
E02006532,0,1,1,0,0,2
E02006533,0,6,1,0,0,7
E02006534,0,7,3,0,0,10
E02006535,1,2,2,0,0,5
E02006536,0,7,1,0,0,8
E02006537,0,0,1,0,0,1
E02006538,0,2,0,0,0,2
E02006539,0,2,2,0,0,4
E02006540,0,2,0,0,0,2
E02006541,0,7,1,0,0,8
E02006542,0,0,0,1,0,1
E02006543,0,2,0,0,0,2
E02006544,0,1,0,0,0,1
E02006545,0,1,0,2,0,3
E02006546,0,5,1,0,0,6
E02006547,0,1,0,0,0,1
E02006548,0,3,8,0,0,11
E02006549,1,1,1,1,0,4
E02006550,1,4,1,1,0,7
E02006551,0,4,0,0,0,4
E02006552,0,3,2,0,0,5
E02006553,0,0,0,0,0,0
E02006554,0,1,0,0,0,1
E02006555,1,1,1,0,0,3
E02006556,0,1,0,0,0,1
E02006557,0,1,0,0,0,1
E02006558,0,4,8,1,0,13
E02006559,0,0,1,1,0,2
E02006560,0,1,1,0,0,2
E02006561,3,10,6,0,0,19
E02006562,0,2,1,0,0,3
E02006563,0,1,0,0,0,1
E02006564,0,1,0,0,0,1
E02006565,0,16,1,0,0,17
E02006566,0,2,0,0,0,2
E02006567,0,1,0,0,0,1
E02006568,0,1,9,0,0,10
E02006569,0,8,0,0,0,8
E02006570,0,2,5,0,0,7
E02006571,0,1,0,1,0,2
E02006572,0,0,0,0,0,0
E02006573,2,1,4,0,0,7
E02006574,0,4,0,0,0,4
E02006575,1,4,1,0,0,6
E02006576,0,3,1,0,0,4
E02006577,1,3,6,0,0,10
E02006578,1,5,3,0,0,9
E02006579,1,3,1,0,0,5
E02006580,0,7,1,0,0,8
E02006581,1,5,5,0,0,11
E02006582,1,2,0,0,1,4
E02006583,1,7,1,0,0,9
E02006584,0,0,3,0,0,3
E02006585,0,5,0,1,0,6
E02006586,0,1,0,0,0,1
E02006587,0,2,0,0,0,2
E02006588,0,7,2,0,0,9
E02006589,0,4,7,1,0,12
E02006590,0,3,4,1,0,8
E02006591,2,3,9,1,1,16
E02006592,2,4,1,0,0,7
E02006593,1,6,6,1,0,14
E02006594,0,2,2,1,1,6
E02006595,1,3,0,1,1,6
E02006596,0,2,0,0,0,2
E02006597,1,1,1,0,0,3
E02006598,1,1,0,0,0,2
E02006599,2,1,4,0,0,7
E02006600,0,8,2,0,0,10
E02006601,0,4,5,2,1,12
E02006602,1,1,1,0,0,3
E02006603,0,5,1,0,0,6
E02006604,0,8,1,1,0,10
E02006605,0,2,11,0,0,13
E02006606,1,6,1,0,0,8
E02006607,0,25,2,0,0,27
E02006608,0,6,1,0,1,8
E02006609,0,0,0,1,0,1
E02006610,1,12,4,0,0,17
E02006611,0,5,6,0,0,11
E02006612,0,24,9,0,0,33
E02006613,0,3,1,0,0,4
E02006614,1,1,3,0,1,6
E02006615,0,2,0,0,0,2
E02006616,0,2,0,0,0,2
E02006617,1,4,2,0,0,7
E02006618,0,4,5,1,0,10
E02006619,4,1,0,0,1,6
E02006620,1,1,1,0,1,4
E02006621,0,7,2,0,0,9
E02006622,0,3,0,0,0,3
E02006623,1,2,0,0,0,3
E02006624,1,1,1,0,0,3
E02006625,0,2,1,0,0,3
E02006626,0,1,1,1,0,3
E02006627,1,2,0,0,0,3
E02006628,0,1,2,1,0,4
E02006629,0,1,0,1,0,2
E02006630,0,15,6,3,0,24
E02006631,0,1,3,0,0,4
E02006632,0,2,2,0,1,5
E02006633,0,11,1,0,1,13
E02006634,2,15,2,1,1,21
E02006635,0,8,12,0,0,20
E02006636,0,3,0,0,0,3
E02006637,0,3,1,0,0,4
E02006638,0,1,2,1,0,4
E02006639,1,2,0,0,0,3
E02006640,0,2,2,0,0,4
E02006641,0,8,9,1,0,18
E02006642,0,0,2,0,0,2
E02006643,0,1,0,0,0,1
E02006644,1,3,1,0,0,5
E02006645,1,7,2,1,0,11
E02006646,0,12,1,0,0,13
E02006647,0,3,1,0,0,4
E02006648,0,8,4,1,0,13
E02006649,1,10,11,0,1,23
E02006650,0,9,1,0,1,11
E02006651,0,0,1,0,0,1
E02006652,1,1,0,2,0,4
E02006653,0,1,0,0,0,1
E02006654,2,1,2,1,0,6
E02006655,0,10,8,0,0,18
E02006656,1,1,0,0,0,2
E02006657,0,4,3,0,0,7
E02006658,0,3,0,0,0,3
E02006659,1,4,0,0,0,5
E02006660,0,1,3,1,0,5
E02006661,0,0,1,0,0,1
E02006662,0,4,0,0,0,4
E02006663,2,2,1,0,0,5
E02006664,0,1,1,0,0,2
E02006665,0,1,0,0,0,1
E02006666,1,3,4,0,0,8
E02006667,0,3,0,0,0,3
E02006668,0,4,0,1,0,5
E02006669,0,2,2,0,0,4
E02006670,0,1,5,0,0,6
E02006671,1,5,1,1,0,8
E02006672,0,3,1,0,0,4
E02006673,0,4,4,0,0,8
E02006674,0,4,0,0,0,4
E02006675,0,2,1,0,0,3
E02006676,0,0,0,0,0,0
E02006677,0,0,5,2,0,7
E02006678,0,2,3,0,0,5
E02006679,0,4,1,0,0,5
E02006680,0,2,3,2,0,7
E02006681,0,3,1,0,1,5
E02006682,0,1,2,0,0,3
E02006683,0,3,0,1,0,4
E02006684,0,2,5,7,0,14
E02006685,0,0,0,0,0,0
E02006686,0,0,0,0,0,0
E02006687,0,0,1,1,0,2
E02006688,0,2,1,1,0,4
E02006689,0,1,1,0,0,2
E02006690,1,4,0,0,0,5
E02006691,1,6,4,0,0,11
E02006692,2,0,1,0,0,3
E02006693,1,2,0,0,0,3
E02006694,1,1,4,0,0,6
E02006695,0,3,0,0,0,3
E02006696,1,3,0,0,0,4
E02006697,3,3,5,2,0,13
E02006698,2,11,2,0,0,15
E02006699,2,3,2,0,0,7
E02006700,0,11,3,1,0,15
E02006701,0,0,1,0,0,1
E02006702,1,4,8,1,0,14
E02006703,1,4,5,0,0,10
E02006704,1,6,1,0,0,8
E02006705,2,5,2,0,0,9
E02006706,2,18,11,1,0,32
E02006707,0,1,1,0,0,2
E02006708,0,4,1,0,1,6
E02006709,0,1,0,0,0,1
E02006710,1,0,1,0,0,2
E02006711,0,4,2,0,0,6
E02006712,1,3,0,0,0,4
E02006713,0,5,1,0,0,6
E02006714,1,4,1,0,0,6
E02006715,0,2,1,0,0,3
E02006716,0,2,1,1,0,4
E02006717,0,3,0,0,0,3
E02006718,0,5,2,0,0,7
E02006719,0,7,0,0,0,7
E02006720,0,1,0,2,0,3
E02006721,0,1,2,0,0,3
E02006722,0,0,0,0,0,0
E02006723,1,3,2,1,0,7
E02006724,1,8,0,0,0,9
E02006725,0,3,0,0,0,3
E02006726,0,3,3,0,1,7
E02006727,0,2,1,0,0,3
E02006728,0,2,2,0,0,4
E02006729,1,2,3,0,0,6
E02006730,0,1,1,0,0,2
E02006731,0,2,2,1,0,5
E02006732,0,5,3,1,0,9
E02006733,0,2,0,1,0,3
E02006734,0,1,1,1,1,4
E02006735,0,3,0,0,0,3
E02006736,0,1,0,0,0,1
E02006737,1,2,0,0,0,3
E02006738,0,4,1,0,0,5
E02006739,1,4,0,0,0,5
E02006740,2,2,0,0,0,4
E02006741,0,5,4,1,0,10
E02006742,0,1,0,0,0,1
E02006743,0,2,1,0,0,3
E02006744,0,1,0,0,0,1
E02006745,0,7,8,0,0,15
E02006746,0,5,1,0,0,6
E02006747,0,1,0,1,0,2
E02006748,0,1,3,0,0,4
E02006749,1,0,0,1,0,2
E02006750,0,6,2,0,0,8
E02006751,0,5,0,1,0,6
E02006752,0,2,0,1,0,3
E02006753,0,1,0,0,0,1
E02006754,1,1,0,0,0,2
E02006755,0,3,0,0,0,3
E02006756,0,2,1,0,0,3
E02006757,0,9,2,1,0,12
E02006758,1,0,0,1,0,2
E02006759,1,2,0,0,0,3
E02006760,0,8,0,1,0,9
E02006761,2,6,2,0,1,11
E02006762,0,4,2,1,1,8
E02006763,1,9,2,0,0,12
E02006764,1,7,3,0,0,11
E02006765,0,4,1,1,0,6
E02006766,0,1,2,1,0,4
E02006767,1,3,1,0,0,5
E02006768,1,8,2,0,0,11
E02006769,0,4,2,1,0,7
E02006770,2,3,1,1,0,7
E02006771,1,2,2,0,0,5
E02006772,0,1,7,1,0,9
E02006773,3,17,6,0,0,26
E02006774,0,5,0,0,0,5
E02006775,2,4,2,0,0,8
E02006776,1,11,2,0,0,14
E02006777,1,6,0,0,1,8
E02006778,0,2,2,0,0,4
E02006779,0,1,0,0,0,1
E02006780,2,2,2,0,0,6
E02006781,0,0,0,0,0,0
E02006782,5,8,0,1,0,14
E02006783,3,1,0,0,0,4
E02006784,1,6,1,0,0,8
E02006785,1,3,0,0,0,4
E02006786,0,2,1,0,1,4
E02006787,1,2,1,0,0,4
E02006788,2,4,1,0,0,7
E02006789,0,7,1,0,0,8
E02006790,2,7,2,1,0,12
E02006791,0,6,0,0,0,6
E02006792,4,6,0,0,0,10
E02006793,5,10,1,0,0,16
E02006794,0,11,3,0,0,14
E02006795,3,12,0,0,0,15
E02006796,1,5,1,1,0,8
E02006798,2,9,2,1,0,14
E02006799,1,5,1,0,0,7
E02006800,4,13,0,0,0,17
E02006801,0,1,1,0,0,2
E02006802,3,6,1,0,0,10
E02006803,0,2,0,0,0,2
E02006804,2,9,4,0,0,15
E02006805,0,7,1,0,0,8
E02006806,0,4,4,3,0,11
E02006807,0,3,0,0,0,3
E02006808,1,8,0,0,0,9
E02006809,3,8,1,1,0,13
E02006810,0,5,1,1,1,8
E02006811,3,7,2,1,0,13
E02006812,0,2,2,0,0,4
E02006813,0,2,2,1,0,5
E02006814,0,4,2,0,0,6
E02006815,0,9,7,2,0,18
E02006816,0,3,3,0,0,6
E02006817,0,1,3,0,2,6
E02006818,1,8,2,2,0,13
E02006819,0,1,3,0,0,4
E02006820,0,1,4,1,1,7
E02006821,3,2,0,0,0,5
E02006822,0,6,3,0,0,9
E02006823,2,4,3,0,0,9
E02006824,1,3,0,0,0,4
E02006825,0,4,0,0,0,4
E02006826,0,2,1,0,0,3
E02006827,1,2,1,1,0,5
E02006828,0,1,0,0,0,1
E02006829,0,6,1,1,1,9
E02006830,0,1,0,0,0,1
E02006831,0,6,2,0,0,8
E02006832,0,0,1,0,0,1
E02006833,1,2,0,0,0,3
E02006834,0,4,4,0,0,8
E02006835,0,6,4,0,0,10
E02006836,0,12,1,0,0,13
E02006837,4,16,2,1,0,23
E02006838,0,0,2,0,0,2
E02006839,0,9,5,1,0,15
E02006840,2,0,1,0,0,3
E02006841,0,3,2,0,0,5
E02006842,2,10,5,2,0,19
E02006843,0,1,0,0,0,1
E02006844,0,0,0,0,0,0
E02006845,0,0,6,6,1,13
E02006846,0,0,0,0,0,0
E02006847,0,12,3,0,0,15
E02006848,0,2,0,0,0,2
E02006849,0,0,2,0,0,2
E02006850,0,2,1,7,0,10
E02006851,0,0,0,0,0,0
E02006852,0,0,1,0,0,1
E02006853,1,2,0,0,0,3
E02006854,1,0,0,0,0,1
E02006855,0,2,2,0,0,4
E02006856,0,2,7,3,1,13
E02006857,0,4,1,0,0,5
E02006858,1,3,0,0,0,4
E02006859,0,1,0,0,0,1
E02006860,0,8,3,1,0,12
E02006861,1,4,0,0,0,5
E02006862,0,5,1,1,0,7
E02006863,0,1,1,0,0,2
E02006864,1,3,0,0,0,4
E02006865,1,1,1,0,0,3
E02006866,0,2,3,0,0,5
E02006867,0,2,0,0,0,2
E02006868,2,7,1,1,1,12
E02006869,0,8,4,0,1,13
E02006870,0,4,5,1,0,10
E02006871,0,1,0,0,0,1
E02006872,0,11,3,1,3,18
E02006873,0,1,0,0,0,1
E02006874,2,1,2,0,0,5
E02006875,0,0,0,0,0,0
E02006876,0,12,1,1,0,14
E02006877,0,2,4,0,0,6
E02006878,0,2,2,1,1,6
E02006879,1,2,3,3,0,9
E02006880,0,5,5,1,0,11
E02006881,0,9,5,2,0,16
E02006882,2,14,6,0,0,22
E02006883,1,1,0,0,0,2
E02006884,0,3,4,1,0,8
E02006885,0,3,0,0,0,3
E02006886,1,14,0,0,0,15
E02006887,0,1,0,0,0,1
E02006888,0,3,1,0,0,4
E02006889,1,4,2,0,0,7
E02006890,2,1,0,1,0,4
E02006891,0,1,1,1,0,3
E02006892,0,8,1,1,0,10
E02006893,1,13,3,0,0,17
E02006894,3,14,2,0,0,19
E02006895,1,6,0,1,0,8
E02006896,0,1,1,0,0,2
E02006897,2,0,0,1,0,3
E02006898,1,0,0,0,0,1
E02006899,0,3,0,0,0,3
E02006900,6,14,2,0,1,23
E02006901,4,5,1,0,0,10
E02006902,0,0,0,0,0,0
E02006903,0,4,1,0,0,5
E02006904,0,1,0,0,0,1
E02006905,1,2,0,1,0,4
E02006906,1,11,1,1,1,15
E02006907,0,0,0,0,0,0
E02006908,0,0,0,1,0,1
E02006909,0,8,2,0,0,10
E02006910,0,7,3,0,0,10
E02006911,0,6,4,3,0,13
E02006912,0,1,0,0,0,1
E02006913,1,2,0,1,0,4
E02006914,0,0,0,0,0,0
E02006915,1,1,0,0,0,2
E02006916,0,2,1,1,0,4
E02006917,0,0,0,0,0,0
E02006918,0,6,2,0,0,8
E02006919,1,5,4,0,0,10
E02006920,1,4,1,0,0,6
E02006921,0,9,0,0,0,9
E02006922,1,11,2,0,1,15
E02006924,1,10,2,0,0,13
E02006925,3,10,1,0,0,14
E02006926,0,3,1,0,0,4
E02006927,5,5,0,0,0,10
E02006928,0,1,1,0,0,2
E02006929,1,6,0,0,0,7
E02006930,2,2,0,0,0,4
E02006931,2,5,2,0,0,9
E02006932,0,1,0,0,0,1
E02006933,1,1,1,0,0,3
E02006934,0,0,0,0,0,0
W02000001,0,0,2,0,1,3
W02000002,0,1,2,1,0,4
W02000003,0,0,4,0,0,4
W02000004,0,0,1,0,0,1
W02000005,0,1,0,0,0,1
W02000006,0,2,3,2,0,7
W02000007,0,0,1,0,0,1
W02000008,0,2,2,1,0,5
W02000009,0,0,6,2,0,8
W02000010,0,0,0,0,0,0
W02000011,0,1,2,0,0,3
W02000012,0,1,0,0,0,1
W02000013,0,5,1,0,0,6
W02000014,1,8,2,0,0,11
W02000015,0,3,0,0,0,3
W02000016,1,0,0,1,0,2
W02000017,1,1,4,0,0,6
W02000018,0,2,0,2,0,4
W02000019,1,1,3,0,0,5
W02000020,0,1,4,0,0,5
W02000021,0,3,4,1,0,8
W02000022,0,0,0,1,0,1
W02000023,0,4,0,0,0,4
W02000024,0,1,1,1,0,3
W02000025,0,0,0,0,0,0
W02000026,1,4,0,1,0,6
W02000027,0,0,2,0,1,3
W02000028,0,4,3,1,0,8
W02000029,0,2,4,3,1,10
W02000030,0,1,3,1,1,6
W02000031,0,7,3,3,0,13
W02000032,0,3,2,3,0,8
W02000033,0,2,1,1,0,4
W02000034,0,4,2,1,1,8
W02000035,1,2,2,3,0,8
W02000036,0,6,4,4,2,16
W02000037,0,0,1,0,0,1
W02000038,0,0,2,2,0,4
W02000039,0,0,2,0,0,2
W02000040,0,3,1,0,0,4
W02000041,0,3,1,0,1,5
W02000042,0,3,3,2,1,9
W02000043,1,3,6,0,0,10
W02000044,1,4,5,0,0,10
W02000045,0,11,9,3,0,23
W02000047,0,0,0,0,0,0
W02000049,0,1,1,2,0,4
W02000050,0,4,0,0,1,5
W02000051,0,1,1,2,0,4
W02000052,0,0,2,0,0,2
W02000053,0,1,8,1,1,11
W02000054,0,2,0,0,1,3
W02000055,0,1,1,3,0,5
W02000056,0,1,0,1,0,2
W02000057,0,4,1,0,1,6
W02000058,0,2,3,0,0,5
W02000059,0,5,3,0,2,10
W02000060,0,2,4,2,1,9
W02000061,1,7,2,1,1,12
W02000062,0,2,3,0,0,5
W02000063,0,1,1,1,0,3
W02000064,0,3,3,0,1,7
W02000065,0,4,1,0,1,6
W02000066,0,5,3,2,0,10
W02000067,1,1,1,1,0,4
W02000068,1,2,2,1,1,7
W02000069,0,3,1,0,0,4
W02000070,0,3,2,0,0,5
W02000071,0,5,1,0,0,6
W02000072,0,5,5,5,0,15
W02000073,0,4,7,3,0,14
W02000074,0,6,1,2,0,9
W02000075,0,1,1,0,0,2
W02000076,0,2,3,0,0,5
W02000077,1,0,0,0,0,1
W02000080,0,0,1,1,0,2
W02000081,0,2,0,0,1,3
W02000082,0,1,0,2,2,5
W02000083,0,1,3,1,2,7
W02000084,0,2,1,2,1,6
W02000085,0,3,3,1,2,9
W02000086,0,0,7,0,1,8
W02000087,0,2,2,3,0,7
W02000088,1,3,2,3,0,9
W02000089,0,0,2,2,0,4
W02000090,0,1,2,0,1,4
W02000091,1,2,0,0,1,4
W02000092,0,0,3,1,0,4
W02000093,0,1,0,0,0,1
W02000094,0,2,2,1,0,5
W02000095,0,1,1,0,1,3
W02000096,0,1,1,1,0,3
W02000097,0,5,1,2,1,9
W02000098,0,3,1,0,0,4
W02000099,0,4,1,0,0,5
W02000100,0,1,0,0,0,1
W02000101,0,1,2,0,0,3
W02000102,0,2,1,1,0,4
W02000103,0,0,0,0,0,0
W02000104,1,3,2,0,0,6
W02000105,0,2,1,0,0,3
W02000106,1,0,0,0,0,1
W02000107,1,2,1,0,0,4
W02000108,0,8,2,0,1,11
W02000109,0,0,0,0,0,0
W02000110,0,2,0,0,0,2
W02000111,0,3,0,0,0,3
W02000113,0,3,2,0,0,5
W02000114,1,1,0,0,0,2
W02000116,0,0,0,0,0,0
W02000117,0,0,0,0,0,0
W02000118,0,1,0,0,0,1
W02000120,0,0,1,0,0,1
W02000122,0,0,0,0,0,0
W02000123,0,1,0,0,0,1
W02000124,1,1,0,0,0,2
W02000125,0,0,0,0,0,0
W02000126,0,1,1,0,0,2
W02000127,0,1,2,0,0,3
W02000128,0,0,3,0,0,3
W02000129,0,1,1,0,1,3
W02000130,0,2,0,0,0,2
W02000131,0,4,0,0,0,4
W02000132,0,0,0,0,0,0
W02000133,0,2,2,0,0,4
W02000134,0,2,1,0,0,3
W02000135,0,2,0,0,1,3
W02000136,0,1,1,0,0,2
W02000137,0,0,1,0,0,1
W02000138,0,2,1,0,0,3
W02000139,0,1,1,0,0,2
W02000140,0,1,1,0,0,2
W02000141,0,5,0,0,0,5
W02000142,0,1,1,0,0,2
W02000143,0,1,0,0,0,1
W02000144,0,0,0,0,0,0
W02000145,1,0,2,0,0,3
W02000146,1,0,0,0,0,1
W02000147,0,2,0,0,0,2
W02000148,0,0,0,0,0,0
W02000149,0,0,0,0,0,0
W02000151,0,0,1,0,0,1
W02000152,0,1,14,1,0,16
W02000153,0,3,0,1,0,4
W02000154,0,0,0,1,0,1
W02000156,0,4,4,0,0,8
W02000157,0,1,1,0,0,2
W02000158,0,0,1,0,0,1
W02000159,0,1,0,0,0,1
W02000160,0,2,0,0,0,2
W02000161,0,6,2,0,0,8
W02000162,1,1,0,0,0,2
W02000163,0,1,1,0,0,2
W02000164,0,3,0,0,1,4
W02000165,0,6,1,0,0,7
W02000166,0,3,4,1,0,8
W02000167,0,3,2,0,0,5
W02000168,1,6,0,0,0,7
W02000169,0,5,2,0,0,7
W02000170,1,6,1,0,0,8
W02000171,0,3,2,0,0,5
W02000172,1,14,1,0,0,16
W02000173,0,0,1,1,0,2
W02000174,2,5,3,0,0,10
W02000175,0,19,3,1,0,23
W02000176,0,6,0,0,0,6
W02000177,0,0,2,0,0,2
W02000178,1,2,1,0,0,4
W02000179,1,4,2,1,0,8
W02000180,0,4,0,0,0,4
W02000181,1,8,4,0,0,13
W02000182,0,4,1,1,0,6
W02000183,1,3,1,0,0,5
W02000184,0,3,1,0,0,4
W02000185,0,2,1,0,0,3
W02000186,0,2,0,0,0,2
W02000187,0,3,0,0,0,3
W02000188,0,2,0,0,0,2
W02000189,1,5,1,0,0,7
W02000190,0,1,0,0,0,1
W02000191,2,2,1,1,0,6
W02000192,0,6,3,0,0,9
W02000193,0,3,2,0,0,5
W02000194,0,4,1,0,0,5
W02000195,1,3,1,0,0,5
W02000196,0,10,1,0,0,11
W02000197,0,0,1,1,0,2
W02000198,0,5,5,3,0,13
W02000200,0,4,1,0,0,5
W02000201,0,2,2,0,0,4
W02000202,1,8,0,0,0,9
W02000203,0,2,1,0,0,3
W02000204,0,3,1,0,0,4
W02000205,0,3,1,0,0,4
W02000206,0,6,4,1,0,11
W02000207,0,1,3,1,0,5
W02000208,0,5,1,0,0,6
W02000209,0,0,1,0,0,1
W02000210,0,1,0,0,0,1
W02000211,0,4,0,0,0,4
W02000212,0,4,1,0,0,5
W02000213,0,1,1,0,0,2
W02000214,0,7,1,1,0,9
W02000215,0,3,0,0,0,3
W02000216,1,7,10,0,0,18
W02000217,1,0,2,1,0,4
W02000218,0,0,2,0,0,2
W02000219,1,5,1,0,0,7
W02000220,0,5,2,0,0,7
W02000221,0,2,2,0,0,4
W02000222,1,12,2,1,0,16
W02000223,0,1,0,0,0,1
W02000224,0,1,1,0,0,2
W02000225,0,1,3,0,0,4
W02000226,0,5,1,0,0,6
W02000227,0,1,0,0,0,1
W02000228,1,3,1,0,2,7
W02000229,0,0,0,1,0,1
W02000230,1,5,0,0,0,6
W02000231,0,1,0,0,0,1
W02000232,0,6,0,0,1,7
W02000233,0,4,1,0,0,5
W02000234,0,2,0,0,0,2
W02000235,1,5,5,1,0,12
W02000236,1,2,0,0,0,3
W02000237,0,1,0,0,0,1
W02000238,2,1,2,0,0,5
W02000239,0,2,0,0,0,2
W02000240,0,4,3,0,0,7
W02000241,2,5,2,1,0,10
W02000242,0,3,2,1,0,6
W02000243,0,5,1,0,0,6
W02000244,0,7,0,1,1,9
W02000245,2,4,2,2,1,11
W02000246,1,1,2,2,0,6
W02000247,2,2,1,0,0,5
W02000248,0,4,2,0,0,6
W02000249,2,12,1,2,2,19
W02000250,0,3,1,1,0,5
W02000251,0,4,2,1,0,7
W02000252,0,4,2,1,0,7
W02000253,1,3,2,0,0,6
W02000254,1,1,2,1,1,6
W02000255,1,6,2,2,0,11
W02000256,1,3,2,1,0,7
W02000257,0,3,1,0,0,4
W02000258,1,9,2,1,0,13
W02000259,1,3,2,1,0,7
W02000260,1,4,1,0,0,6
W02000261,0,5,6,1,0,12
W02000262,0,5,4,1,0,10
W02000263,1,2,1,0,0,4
W02000264,0,1,2,0,1,4
W02000265,0,10,3,0,0,13
W02000266,0,5,0,3,1,9
W02000267,0,8,2,2,0,12
W02000268,2,21,6,0,0,29
W02000269,1,4,1,1,0,7
W02000270,0,9,0,1,1,11
W02000271,0,5,2,0,0,7
W02000272,3,14,10,1,0,28
W02000273,0,2,0,3,0,5
W02000274,0,17,3,1,1,22
W02000275,0,3,3,1,0,7
W02000276,0,7,1,2,0,10
W02000277,0,14,4,0,0,18
W02000278,0,2,0,0,1,3
W02000279,0,4,0,0,0,4
W02000280,0,5,1,0,0,6
W02000281,0,4,0,2,0,6
W02000282,0,4,2,1,0,7
W02000284,0,6,1,0,0,7
W02000285,0,6,3,0,0,9
W02000286,0,6,1,0,0,7
W02000287,0,5,2,1,0,8
W02000288,0,10,5,1,0,16
W02000289,0,14,2,0,0,16
W02000290,1,1,1,0,0,3
W02000291,1,4,0,1,1,7
W02000292,1,5,1,0,0,7
W02000293,1,1,0,0,0,2
W02000294,1,4,0,0,0,5
W02000295,2,6,0,0,0,8
W02000296,1,2,0,0,0,3
W02000297,0,3,0,0,0,3
W02000298,1,3,3,0,0,7
W02000299,0,1,0,0,0,1
W02000300,1,2,0,0,0,3
W02000301,4,11,0,0,0,15
W02000302,0,7,0,0,0,7
W02000303,1,3,0,0,0,4
W02000304,1,2,1,0,0,4
W02000305,0,2,0,0,1,3
W02000306,0,6,0,2,0,8
W02000307,1,1,1,0,0,3
W02000308,2,6,0,0,0,8
W02000309,2,3,0,0,0,5
W02000310,1,0,0,0,0,1
W02000311,1,8,2,0,0,11
W02000312,0,5,0,0,0,5
W02000313,2,6,2,1,0,11
W02000314,1,3,1,0,0,5
W02000315,2,14,2,0,0,18
W02000316,2,4,0,0,0,6
W02000317,1,3,1,0,0,5
W02000318,0,8,1,0,0,9
W02000319,0,3,0,1,0,4
W02000320,1,2,0,0,0,3
W02000321,2,5,1,0,0,8
W02000322,0,5,1,0,0,6
W02000323,0,4,0,0,0,4
W02000324,0,3,0,0,0,3
W02000325,0,3,1,0,0,4
W02000326,0,5,0,0,0,5
W02000327,0,0,0,0,0,0
W02000328,1,3,2,0,0,6
W02000329,3,6,1,1,0,11
W02000330,0,6,1,0,0,7
W02000331,1,0,0,0,0,1
W02000332,5,2,1,1,0,9
W02000333,0,2,0,0,0,2
W02000334,1,4,0,0,0,5
W02000335,3,6,0,0,0,9
W02000336,1,3,10,1,0,15
W02000337,1,4,2,0,0,7
W02000338,0,3,4,1,0,8
W02000339,1,4,1,0,0,6
W02000340,0,1,2,0,0,3
W02000341,0,2,0,0,0,2
W02000342,0,4,1,1,0,6
W02000343,3,7,1,0,0,11
W02000344,1,1,1,0,0,3
W02000345,3,5,0,0,0,8
W02000346,1,3,1,0,0,5
W02000347,4,1,0,0,0,5
W02000348,2,9,1,0,0,12
W02000349,2,9,0,0,0,11
W02000350,0,5,2,0,0,7
W02000351,0,6,1,0,0,7
W02000352,2,0,0,0,0,2
W02000353,0,1,1,0,0,2
W02000354,1,0,1,0,0,2
W02000355,1,15,4,1,0,21
W02000356,1,3,1,0,0,5
W02000357,0,3,3,0,0,6
W02000358,0,3,2,0,0,5
W02000359,2,13,0,0,0,15
W02000360,1,2,3,0,0,6
W02000361,0,4,0,0,0,4
W02000362,2,2,2,0,0,6
W02000363,1,4,0,0,0,5
W02000364,2,6,14,0,0,22
W02000365,3,2,0,0,0,5
W02000366,0,8,6,0,0,14
W02000367,0,9,2,0,0,11
W02000368,0,3,0,0,0,3
W02000369,0,2,0,0,0,2
W02000370,3,1,3,0,0,7
W02000371,0,9,2,1,0,12
W02000372,1,4,1,1,0,7
W02000373,0,6,2,0,0,8
W02000374,0,3,0,0,0,3
W02000375,0,13,4,0,0,17
W02000376,0,3,3,0,1,7
W02000377,0,7,2,1,0,10
W02000378,3,2,4,1,0,10
W02000379,0,3,0,1,0,4
W02000380,0,7,2,1,0,10
W02000381,1,5,2,1,0,9
W02000382,3,11,3,0,0,17
W02000383,0,3,1,0,0,4
W02000384,0,2,2,0,0,4
W02000385,0,4,0,1,0,5
W02000386,0,7,3,1,0,11
W02000387,1,7,0,0,0,8
W02000388,0,6,2,2,0,10
W02000389,0,9,5,1,0,15
W02000390,0,12,4,0,0,16
W02000391,0,1,2,1,0,4
W02000392,1,2,2,0,0,5
W02000393,1,5,0,0,0,6
W02000394,0,7,5,0,1,13
W02000395,0,1,1,0,0,2
W02000396,0,0,1,0,0,1
W02000397,0,4,1,0,2,7
W02000398,0,0,1,0,0,1
W02000399,0,9,4,0,0,13
W02000400,1,3,0,0,0,4
W02000401,0,3,2,0,0,5
W02000402,0,6,1,0,0,7
W02000403,0,0,2,0,0,2
W02000404,0,5,0,0,0,5
W02000405,0,3,0,0,0,3
W02000406,2,21,2,0,0,25
W02000407,0,7,2,2,0,11
W02000408,0,2,1,0,0,3
W02000409,0,2,2,0,0,4
W02000410,0,1,3,1,0,5
W02000411,1,15,4,1,0,21
W02000412,1,1,2,1,1,6
W02000414,0,8,0,0,0,8
W02000415,0,1,1,0,0,2
W02000416,0,14,8,1,0,23
W02000417,0,3,2,0,0,5
W02000418,0,3,1,0,0,4
W02000419,1,2,6,2,0,11
W02000420,0,5,3,3,3,14
W02000421,1,1,0,0,0,2
W02000422,0,1,1,0,0,2
W02000423,1,9,3,1,3,17
